행정기관코드,행정기관코드/100,법정동코드,행정기관,총인구수,세대수,남자 인구수,여자 인구수
1100000000,11000000,#N/A,서울특별시  ,10200440,4094350,5062552,5137888
1111000000,11110000,#N/A,서울특별시 종로구 ,170587,74565,85427,85160
1111051000,11110510,1101051,서울특별시 종로구 청운동,4739,1680,2420,2319
1111052000,11110520,1101052,서울특별시 종로구 효자동,11892,4760,5753,6139
1111053000,11110530,1101053,서울특별시 종로구 사직동,9897,4393,4673,5224
1111054000,11110540,1101054,서울특별시 종로구 삼청동,3702,1707,1795,1907
1111055000,11110550,1101055,서울특별시 종로구 부암동,11625,4608,5767,5858
1111056000,11110560,1101056,서울특별시 종로구 평창동,19391,7074,9447,9944
1111057000,11110570,1101057,서울특별시 종로구 무악동,8624,3159,4182,4442
1111058000,11110580,1101058,서울특별시 종로구 교남동,9178,4413,4504,4674
1111060000,11110600,1101060,서울특별시 종로구 가회동,5836,2496,2831,3005
1111061500,11110615,1101061,서울특별시 종로구 종로1.2.3.4가동,7202,4398,4060,3142
1111063000,11110630,1101063,서울특별시 종로구 종로5.6가동,6528,3045,3489,3039
1111064000,11110640,1101064,서울특별시 종로구 이화동,9608,4534,4660,4948
1111065000,11110650,1101065,서울특별시 종로구 혜화동,12312,5616,6040,6272
1111066000,11110660,1101066,서울특별시 종로구 명륜3가동,6740,3734,3720,3020
1111067000,11110670,1101067,서울특별시 종로구 창신제1동,7067,3486,3649,3418
1111068000,11110680,1101068,서울특별시 종로구 창신제2동,11977,5121,6104,5873
1111069000,11110690,1101069,서울특별시 종로구 창신제3동,8652,3167,4371,4281
1111070000,11110700,1101070,서울특별시 종로구 숭인제1동,7359,3099,3644,3715
1111071000,11110710,1101071,서울특별시 종로구 숭인제2동,8258,4075,4318,3940
1114000000,11140000,#N/A,서울특별시 중구 ,130720,58287,65295,65425
1114052000,11140520,1102052,서울특별시 중구 소공동,1038,548,527,511
1114054000,11140540,1102054,서울특별시 중구 회현동,4524,2633,2479,2045
1114055000,11140550,1102055,서울특별시 중구 명동,2831,1332,1241,1590
1114057000,11140570,1102057,서울특별시 중구 필동,4639,2294,2447,2192
1114058000,11140580,1102058,서울특별시 중구 장충동,5849,2948,2940,2909
1114059000,11140590,1102059,서울특별시 중구 광희동,4993,2696,2705,2288
1114060500,11140605,1102060,서울특별시 중구 을지로동,1814,1193,1080,734
1114061000,11140610,1102061,서울특별시 중구 신당제1동,8338,3999,4244,4094
1114062000,11140620,1102062,서울특별시 중구 신당제2동,16832,7138,8266,8566
1114063000,11140630,1102063,서울특별시 중구 신당제3동,20002,8126,9690,10312
1114064000,11140640,1102064,서울특별시 중구 신당제4동,16401,6484,7952,8449
1114065000,11140650,1102065,서울특별시 중구 신당제5동,8679,3927,4380,4299
1114066000,11140660,1102066,서울특별시 중구 신당제6동,10635,4149,5241,5394
1114067000,11140670,1102067,서울특별시 중구 황학동,11247,5205,5710,5537
1114068000,11140680,1102068,서울특별시 중구 중림동,12898,5615,6393,6505
1117000000,11170000,#N/A,서울특별시 용산구 ,237616,106698,116510,121106
1117051000,11170510,1103051,서울특별시 용산구 후암동,20148,8882,10063,10085
1117052000,11170520,1103052,서울특별시 용산구 용산2가동,13246,5931,6557,6689
1117053000,11170530,1103053,서울특별시 용산구 남영동,7487,4527,4324,3163
1117055500,11170555,1103071,서울특별시 용산구 청파동,23434,11252,11433,12001
1117056000,11170560,1103072,서울특별시 용산구 원효로제1동,10235,4650,5149,5086
1117057000,11170570,1103057,서울특별시 용산구 원효로제2동,16280,6245,7823,8457
1117058000,11170580,1103058,서울특별시 용산구 효창동,10655,4204,5266,5389
1117059000,11170590,1103059,서울특별시 용산구 용문동,12693,4779,6258,6435
1117062500,11170625,1103073,서울특별시 용산구 한강로동,13974,7122,7074,6900
1117063000,11170630,1103063,서울특별시 용산구 이촌제1동,26968,9868,12724,14244
1117064000,11170640,1103064,서울특별시 용산구 이촌제2동,10509,4417,5016,5493
1117065000,11170650,1103065,서울특별시 용산구 이태원제1동,8449,4300,3994,4455
1117066000,11170660,1103066,서울특별시 용산구 이태원제2동,11299,5215,5361,5938
1117068500,11170685,1103074,서울특별시 용산구 한남동,22238,11526,10883,11355
1117069000,11170690,1103069,서울특별시 용산구 서빙고동,11398,4829,5557,5841
1117070000,11170700,1103070,서울특별시 용산구 보광동,18603,8951,9028,9575
1120000000,11200000,#N/A,서울특별시 성동구 ,319276,130736,160181,159095
1120052000,11200520,1104052,서울특별시 성동구 왕십리제2동,18941,7430,9392,9549
1120053500,11200535,1104071,서울특별시 성동구 왕십리도선동,16659,7123,8441,8218
1120054000,11200540,1104054,서울특별시 성동구 마장동,26033,10100,13132,12901
1120055000,11200550,1104055,서울특별시 성동구 사근동,10909,5511,5885,5024
1120056000,11200560,1104056,서울특별시 성동구 행당제1동,18220,7790,9002,9218
1120057000,11200570,1104057,서울특별시 성동구 행당제2동,25394,8986,12277,13117
1120058000,11200580,1104058,서울특별시 성동구 응봉동,17682,6526,8504,9178
1120059000,11200590,1104059,서울특별시 성동구 금호1가동,18063,7014,8823,9240
1120061500,11200615,1104072,서울특별시 성동구 금호2.3가동,24294,9878,11874,12420
1120062000,11200620,1104062,서울특별시 성동구 금호4가동,15540,6515,7706,7834
1120064500,11200645,1104073,서울특별시 성동구 옥수동,28022,11541,13804,14218
1120065000,11200650,1104065,서울특별시 성동구 성수1가제1동,18791,7502,9652,9139
1120066000,11200660,1104066,서울특별시 성동구 성수1가제2동,19450,8269,9844,9606
1120067000,11200670,1104067,서울특별시 성동구 성수2가제1동,20019,8392,10406,9613
1120069000,11200690,1104068,서울특별시 성동구 성수2가제3동,12104,5200,6178,5926
1120072000,11200720,1104069,서울특별시 성동구 송정동,11956,5480,6347,5609
1120079000,11200790,1104070,서울특별시 성동구 용답동,17199,7479,8914,8285
1121500000,11215000,#N/A,서울특별시 광진구 ,375959,155513,186412,189547
1121571000,11215710,1105053,서울특별시 광진구 화양동,21329,11872,10560,10769
1121573000,11215730,1105054,서울특별시 광진구 군자동,21802,9945,10976,10826
1121574000,11215740,1105055,서울특별시 광진구 중곡제1동,16970,7409,8437,8533
1121575000,11215750,1105056,서울특별시 광진구 중곡제2동,22823,9167,11254,11569
1121576000,11215760,1105057,서울특별시 광진구 중곡제3동,20150,8317,10112,10038
1121577000,11215770,1105058,서울특별시 광진구 중곡제4동,32497,12291,16140,16357
1121578000,11215780,1105059,서울특별시 광진구 능동,10720,4966,5221,5499
1121581000,11215810,1105063,서울특별시 광진구 광장동,36212,12247,17674,18538
1121582000,11215820,1105064,서울특별시 광진구 자양제1동,24723,10965,12300,12423
1121583000,11215830,1105065,서울특별시 광진구 자양제2동,29334,11391,14762,14572
1121584000,11215840,1105066,서울특별시 광진구 자양제3동,31698,11455,15737,15961
1121584700,11215847,1105067,서울특별시 광진구 자양제4동,27773,12882,14077,13696
1121585000,11215850,1105060,서울특별시 광진구 구의제1동,23375,10828,11356,12019
1121586000,11215860,1105061,서울특별시 광진구 구의제2동,26504,10335,13176,13328
1121587000,11215870,1105062,서울특별시 광진구 구의제3동,30049,11443,14630,15419
1123000000,11230000,#N/A,서울특별시 동대문구 ,372234,156880,187622,184612
1123051000,11230510,1106051,서울특별시 동대문구 신설동,8926,4127,4631,4295
1123053500,11230535,1106077,서울특별시 동대문구 용두동,19198,9264,10055,9143
1123054000,11230540,1106054,서울특별시 동대문구 제기제1동,13080,5918,6681,6399
1123055000,11230550,1106055,서울특별시 동대문구 제기제2동,16238,7199,8275,7963
1123056000,11230560,1106056,서울특별시 동대문구 전농제1동,12126,5262,6205,5921
1123057000,11230570,1106078,서울특별시 동대문구 전농제2동,19570,8975,10216,9354
1123058000,11230580,1106058,서울특별시 동대문구 전농제3동,19533,7143,9656,9877
1123060000,11230600,1106060,서울특별시 동대문구 답십리제1동,11093,4541,5569,5524
1123061000,11230610,1106061,서울특별시 동대문구 답십리제2동,15690,5756,7815,7875
1123062000,11230620,1106079,서울특별시 동대문구 답십리제3동,15505,6568,7883,7622
1123063000,11230630,1106063,서울특별시 동대문구 답십리제4동,15501,5862,7732,7769
1123065000,11230650,1106065,서울특별시 동대문구 장안제1동,18288,7757,9350,8938
1123066000,11230660,1106066,서울특별시 동대문구 장안제2동,17845,6563,9091,8754
1123067000,11230670,1106067,서울특별시 동대문구 장안제3동,18072,6478,9015,9057
1123068000,11230680,1106068,서울특별시 동대문구 장안제4동,14919,5952,7505,7414
1123070500,11230705,1106080,서울특별시 동대문구 청량리동,25412,10811,12754,12658
1123071000,11230710,1106071,서울특별시 동대문구 회기동,11094,5554,5461,5633
1123072000,11230720,1106072,서울특별시 동대문구 휘경제1동,17570,8191,8760,8810
1123073000,11230730,1106073,서울특별시 동대문구 휘경제2동,25029,9840,12301,12728
1123074000,11230740,1106074,서울특별시 동대문구 이문제1동,14273,6640,7081,7192
1123075000,11230750,1106075,서울특별시 동대문구 이문제2동,19264,9504,9660,9604
1123076000,11230760,1106076,서울특별시 동대문구 이문제3동,24008,8975,11926,12082
1126000000,11260000,#N/A,서울특별시 중랑구 ,428247,171029,214377,213870
1126052000,11260520,1107052,서울특별시 중랑구 면목제2동,28737,11818,14517,14220
1126054000,11260540,1107054,서울특별시 중랑구 면목제4동,23988,10178,11686,12302
1126055000,11260550,1107055,서울특별시 중랑구 면목제5동,14875,6242,7598,7277
1126056500,11260565,1107071,서울특별시 중랑구 면목본동,37504,15661,18743,18761
1126057000,11260570,1107057,서울특별시 중랑구 면목제7동,26803,10654,13427,13376
1126057500,11260575,1107072,서울특별시 중랑구 면목제3.8동,30823,12732,15479,15344
1126058000,11260580,1107059,서울특별시 중랑구 상봉제1동,26473,9433,13139,13334
1126059000,11260590,1107060,서울특별시 중랑구 상봉제2동,19036,8817,9656,9380
1126060000,11260600,1107061,서울특별시 중랑구 중화제1동,22134,8169,11063,11071
1126061000,11260610,1107062,서울특별시 중랑구 중화제2동,32467,14601,16572,15895
1126062000,11260620,1107064,서울특별시 중랑구 묵제1동,34699,12718,17176,17523
1126063000,11260630,1107065,서울특별시 중랑구 묵제2동,20356,8215,10299,10057
1126065500,11260655,1107073,서울특별시 중랑구 망우본동,34652,14040,17385,17267
1126066000,11260660,1107068,서울특별시 중랑구 망우제3동,20301,8276,10256,10045
1126068000,11260680,1107069,서울특별시 중랑구 신내1동,29037,10034,14466,14571
1126069000,11260690,1107070,서울특별시 중랑구 신내2동,26362,9441,12915,13447
1129000000,11290000,#N/A,서울특별시 성북구 ,472948,190359,234637,238311
1129052500,11290525,1108081,서울특별시 성북구 성북동,19376,8291,9419,9957
1129055500,11290555,1108082,서울특별시 성북구 삼선동,26859,11559,13177,13682
1129057500,11290575,1108083,서울특별시 성북구 동선동,15275,7365,7097,8178
1129058000,11290580,1108058,서울특별시 성북구 돈암제1동,17958,6676,8732,9226
1129059000,11290590,1108059,서울특별시 성북구 돈암제2동,24653,8664,12050,12603
1129060000,11290600,1108060,서울특별시 성북구 안암동,17662,8701,9080,8582
1129061000,11290610,1108061,서울특별시 성북구 보문동,17349,7627,8654,8695
1129062000,11290620,1108062,서울특별시 성북구 정릉제1동,18193,6727,8713,9480
1129063000,11290630,1108063,서울특별시 성북구 정릉제2동,24424,9445,12177,12247
1129064000,11290640,1108064,서울특별시 성북구 정릉제3동,19105,8182,9578,9527
1129065000,11290650,1108065,서울특별시 성북구 정릉제4동,28247,10758,13971,14276
1129066000,11290660,1108066,서울특별시 성북구 길음제1동,28630,10203,13931,14699
1129068500,11290685,1108068,서울특별시 성북구 길음제2동,21047,9015,10312,10735
1129070500,11290705,1108084,서울특별시 성북구 종암동,36445,14626,18426,18019
1129071500,11290715,1108071,서울특별시 성북구 월곡제1동,27544,10450,13750,13794
1129072500,11290725,1108072,서울특별시 성북구 월곡제2동,21776,8354,10843,10933
1129076000,11290760,1108076,서울특별시 성북구 장위제1동,27659,10753,13802,13857
1129077000,11290770,1108077,서울특별시 성북구 장위제2동,24580,9916,12426,12154
1129078000,11290780,1108078,서울특별시 성북구 장위제3동,18980,7937,9770,9210
1129081000,11290810,1108085,서울특별시 성북구 석관동,37186,15110,18729,18457
1130500000,11305000,#N/A,서울특별시 강북구 ,342575,136213,170021,172554
1130553400,11305534,1109069,서울특별시 강북구 삼양동,33079,13321,16605,16474
1130553500,11305535,1109070,서울특별시 강북구 미아동,24854,10302,12446,12408
1130554500,11305545,1109071,서울특별시 강북구 송중동,36444,14395,17876,18568
1130555500,11305555,1109072,서울특별시 강북구 송천동,33130,13866,16500,16630
1130557500,11305575,1109073,서울특별시 강북구 삼각산동,24675,8486,12222,12453
1130559000,11305590,1109060,서울특별시 강북구 번제1동,20073,8595,9910,10163
1130560000,11305600,1109061,서울특별시 강북구 번제2동,21173,8194,10498,10675
1130560600,11305606,1109062,서울특별시 강북구 번제3동,22329,7829,10828,11501
1130561000,11305610,1109063,서울특별시 강북구 수유제1동,23240,9517,11765,11475
1130562000,11305620,1109064,서울특별시 강북구 수유제2동,23609,9071,11651,11958
1130563000,11305630,1109065,서울특별시 강북구 수유제3동,24106,10489,11976,12130
1130564500,11305645,1109074,서울특별시 강북구 우이동,21706,8603,10926,10780
1130566000,11305660,1109075,서울특별시 강북구 인수동,34157,13545,16818,17339
1132000000,11320000,#N/A,서울특별시 도봉구 ,374459,139678,185668,188791
1132051100,11320511,1110059,서울특별시 도봉구 창제1동,29395,11113,14419,14976
1132051200,11320512,1110060,서울특별시 도봉구 창제2동,31793,12280,15715,16078
1132051300,11320513,1110061,서울특별시 도봉구 창제3동,16800,6694,8486,8314
1132051400,11320514,1110062,서울특별시 도봉구 창제4동,31571,11437,15348,16223
1132051500,11320515,1110063,서울특별시 도봉구 창제5동,28774,10264,14164,14610
1132052100,11320521,1110064,서울특별시 도봉구 도봉제1동,25919,10727,13176,12743
1132052200,11320522,1110065,서울특별시 도봉구 도봉제2동,32937,12207,16406,16531
1132066000,11320660,1110051,서울특별시 도봉구 쌍문제1동,23416,8960,11601,11815
1132067000,11320670,1110052,서울특별시 도봉구 쌍문제2동,21738,8290,10746,10992
1132068000,11320680,1110053,서울특별시 도봉구 쌍문제3동,19044,7398,9361,9683
1132068100,11320681,1110054,서울특별시 도봉구 쌍문제4동,22225,7558,10823,11402
1132069000,11320690,1110055,서울특별시 도봉구 방학제1동,33001,11950,16484,16517
1132070000,11320700,1110056,서울특별시 도봉구 방학제2동,24827,9789,12595,12232
1132071000,11320710,1110057,서울특별시 도봉구 방학제3동,33019,11011,16344,16675
1135000000,11350000,#N/A,서울특별시 노원구 ,616449,224999,302229,314220
1135056000,11350560,1111051,서울특별시 노원구 월계1동,18632,6963,9295,9337
1135057000,11350570,1111052,서울특별시 노원구 월계2동,27996,10680,13624,14372
1135058000,11350580,1111053,서울특별시 노원구 월계3동,27671,9769,13693,13978
1135058100,11350581,1111054,서울특별시 노원구 월계4동,20529,8782,10290,10239
1135060000,11350600,1111056,서울특별시 노원구 공릉2동,46837,16610,23292,23545
1135060500,11350605,1111075,서울특별시 노원구 공릉1.3동,41288,16334,20311,20977
1135061100,11350611,1111058,서울특별시 노원구 하계1동,31711,11512,15353,16358
1135061200,11350612,1111059,서울특별시 노원구 하계2동,26844,8904,13112,13732
1135061900,11350619,1111060,서울특별시 노원구 중계본동,30835,10174,15246,15589
1135062100,11350621,1111061,서울특별시 노원구 중계1동,31791,9994,15629,16162
1135062200,11350622,1111062,서울특별시 노원구 중계2동,18832,6567,9012,9820
1135062300,11350623,1111063,서울특별시 노원구 중계3동,24895,9205,11738,13157
1135062400,11350624,1111064,서울특별시 노원구 중계4동,23908,8578,11675,12233
1135063000,11350630,1111065,서울특별시 노원구 상계1동,40987,14334,20344,20643
1135064000,11350640,1111066,서울특별시 노원구 상계2동,22848,8433,11351,11497
1135066500,11350665,1111076,서울특별시 노원구 상계3.4동,42233,16900,21310,20923
1135067000,11350670,1111069,서울특별시 노원구 상계5동,25075,9345,12317,12758
1135069500,11350695,1111077,서울특별시 노원구 상계6.7동,38398,14834,18245,20153
1135070000,11350700,1111072,서울특별시 노원구 상계8동,27633,9542,13411,14222
1135071000,11350710,1111073,서울특별시 노원구 상계9동,26019,9332,12739,13280
1135072000,11350720,1111074,서울특별시 노원구 상계10동,21487,8207,10242,11245
1138000000,11380000,#N/A,서울특별시 은평구 ,457526,182299,226251,231275
1138051000,11380510,1112051,서울특별시 은평구 녹번동,36300,15565,17711,18589
1138052000,11380520,1112052,서울특별시 은평구 불광제1동,35771,14745,17482,18289
1138053000,11380530,1112072,서울특별시 은평구 불광제2동,32476,13488,16149,16327
1138055100,11380551,1112055,서울특별시 은평구 갈현제1동,27151,10778,13467,13684
1138055200,11380552,1112056,서울특별시 은평구 갈현제2동,27714,10624,13485,14229
1138056000,11380560,1112057,서울특별시 은평구 구산동,32985,11266,17048,15937
1138057000,11380570,1112058,서울특별시 은평구 대조동,31524,13305,15203,16321
1138058000,11380580,1112059,서울특별시 은평구 응암제1동,33321,13735,16397,16924
1138059000,11380590,1112060,서울특별시 은평구 응암제2동,21703,9319,10866,10837
1138060000,11380600,1112073,서울특별시 은평구 응암제3동,27964,11557,13954,14010
1138062500,11380625,1112074,서울특별시 은평구 역촌동,46154,17882,22306,23848
1138063100,11380631,1112065,서울특별시 은평구 신사제1동,27256,10255,13441,13815
1138063200,11380632,1112066,서울특별시 은평구 신사제2동,24683,9394,12579,12104
1138064000,11380640,1112067,서울특별시 은평구 증산동,22090,8600,11062,11028
1138065000,11380650,1112068,서울특별시 은평구 수색동,20974,8484,10434,10540
1138069000,11380690,1112071,서울특별시 은평구 진관동,9460,3302,4667,4793
1141000000,11410000,#N/A,서울특별시 서대문구 ,334069,139311,163524,170545
1141052000,11410520,1113052,서울특별시 서대문구 천연동,19018,7881,9314,9704
1141055500,11410555,1113074,서울특별시 서대문구 북아현동,20073,9112,9679,10394
1141056500,11410565,1113073,서울특별시 서대문구 충현동,23952,10599,11889,12063
1141058500,11410585,1113075,서울특별시 서대문구 신촌동,18779,10284,8627,10152
1141061500,11410615,1113076,서울특별시 서대문구 연희동,41814,18391,20456,21358
1141062000,11410620,1113062,서울특별시 서대문구 홍제제1동,28663,11499,13831,14832
1141064000,11410640,1113064,서울특별시 서대문구 홍제제3동,20818,8340,10173,10645
1141065500,11410655,1113065,서울특별시 서대문구 홍제제2동,16262,6076,7884,8378
1141066000,11410660,1113066,서울특별시 서대문구 홍은제1동,28915,11189,14344,14571
1141068500,11410685,1113068,서울특별시 서대문구 홍은제2동,29559,11493,14587,14972
1141069000,11410690,1113069,서울특별시 서대문구 남가좌제1동,8960,4119,4525,4435
1141070000,11410700,1113070,서울특별시 서대문구 남가좌제2동,31243,12517,15363,15880
1141071000,11410710,1113071,서울특별시 서대문구 북가좌제1동,11901,4736,6022,5879
1141072000,11410720,1113072,서울특별시 서대문구 북가좌제2동,34112,13075,16830,17282
1144000000,11440000,#N/A,서울특별시 마포구 ,385780,166305,188668,197112
1144055500,11440555,1114078,서울특별시 마포구 아현동,18690,8385,9170,9520
1144056500,11440565,1114077,서울특별시 마포구 공덕동,37286,16196,18422,18864
1144058500,11440585,1114075,서울특별시 마포구 도화동,23340,9096,11314,12026
1144059000,11440590,1114059,서울특별시 마포구 용강동,22227,9143,10827,11400
1144060000,11440600,1114060,서울특별시 마포구 대흥동,16331,9156,7987,8344
1144061000,11440610,1114061,서울특별시 마포구 염리동,18806,8384,9191,9615
1144063000,11440630,1114063,서울특별시 마포구 신수동,22504,9579,11231,11273
1144065500,11440655,1114076,서울특별시 마포구 서강동,26373,11971,12767,13606
1144066000,11440660,1114066,서울특별시 마포구 서교동,30021,16025,14072,15949
1144068000,11440680,1114068,서울특별시 마포구 합정동,21428,9312,10545,10883
1144069000,11440690,1114069,서울특별시 마포구 망원제1동,24576,10195,12163,12413
1144070000,11440700,1114070,서울특별시 마포구 망원제2동,21367,8370,10504,10863
1144071000,11440710,1114071,서울특별시 마포구 연남동,19857,8880,9626,10231
1144072000,11440720,1114072,서울특별시 마포구 성산제1동,20215,8274,9996,10219
1144073000,11440730,1114073,서울특별시 마포구 성산제2동,41262,15517,20127,21135
1144074000,11440740,1114074,서울특별시 마포구 상암동,21497,7822,10726,10771
1147000000,11470000,#N/A,서울특별시 양천구 ,502801,183138,250831,251970
1147051000,11470510,1115051,서울특별시 양천구 목1동,31562,10387,15464,16098
1147052000,11470520,1115052,서울특별시 양천구 목2동,32060,12110,15940,16120
1147053000,11470530,1115053,서울특별시 양천구 목3동,23605,9364,11688,11917
1147054000,11470540,1115054,서울특별시 양천구 목4동,29399,10574,14742,14657
1147055000,11470550,1115071,서울특별시 양천구 목5동,47678,14935,23631,24047
1147056000,11470560,1115057,서울특별시 양천구 신월1동,24776,10076,12713,12063
1147057000,11470570,1115058,서울특별시 양천구 신월2동,23679,8809,11882,11797
1147058000,11470580,1115059,서울특별시 양천구 신월3동,18401,7849,9496,8905
1147059000,11470590,1115060,서울특별시 양천구 신월4동,18467,6472,9295,9172
1147060000,11470600,1115061,서울특별시 양천구 신월5동,15387,5917,7667,7720
1147061000,11470610,1115062,서울특별시 양천구 신월6동,15449,6062,7827,7622
1147061100,11470611,1115063,서울특별시 양천구 신월7동,26413,9630,13274,13139
1147062000,11470620,1115064,서울특별시 양천구 신정1동,24920,8757,12336,12584
1147063000,11470630,1115065,서울특별시 양천구 신정2동,23191,7544,11549,11642
1147064000,11470640,1115066,서울특별시 양천구 신정3동,49866,19028,24756,25110
1147065000,11470650,1115072,서울특별시 양천구 신정4동,36141,15038,18043,18098
1147067000,11470670,1115069,서울특별시 양천구 신정6동,28036,8872,13802,14234
1147068000,11470680,1115070,서울특별시 양천구 신정7동,33771,11714,16726,17045
1150000000,11500000,#N/A,서울특별시 강서구 ,576109,222404,284416,291693
1150051000,11500510,1116051,서울특별시 강서구 염창동,41862,14141,20770,21092
1150052000,11500520,1116052,서울특별시 강서구 등촌제1동,21283,8363,10646,10637
1150053000,11500530,1116053,서울특별시 강서구 등촌제2동,23059,8369,11585,11474
1150053500,11500535,1116054,서울특별시 강서구 등촌제3동,38946,14809,18666,20280
1150054000,11500540,1116073,서울특별시 강서구 화곡제1동,50447,20307,25119,25328
1150055000,11500550,1116057,서울특별시 강서구 화곡제2동,20638,8027,10253,10385
1150056000,11500560,1116058,서울특별시 강서구 화곡제3동,24193,8840,11876,12317
1150057000,11500570,1116059,서울특별시 강서구 화곡제4동,22797,9241,11370,11427
1150059000,11500590,1116055,서울특별시 강서구 화곡본동,35533,14544,17496,18037
1150059100,11500591,1116061,서울특별시 강서구 화곡제6동,24795,9692,12220,12575
1150059300,11500593,1116063,서울특별시 강서구 화곡제8동,27238,10843,13452,13786
1150060300,11500603,1116064,서울특별시 강서구 가양제1동,21756,7833,10996,10760
1150060400,11500604,1116065,서울특별시 강서구 가양제2동,18994,7930,9184,9810
1150060500,11500605,1116066,서울특별시 강서구 가양제3동,20081,7812,9691,10390
1150061100,11500611,1116067,서울특별시 강서구 발산제1동,30816,10894,14993,15823
1150061500,11500615,1116074,서울특별시 강서구 우장산동,45601,16380,22303,23298
1150062000,11500620,1116069,서울특별시 강서구 공항동,21629,9710,10978,10651
1150063000,11500630,1116070,서울특별시 강서구 방화제1동,31271,12006,15786,15485
1150064000,11500640,1116071,서울특별시 강서구 방화제2동,26678,11028,13234,13444
1150064100,11500641,1116072,서울특별시 강서구 방화제3동,28492,11635,13798,14694
1153000000,11530000,#N/A,서울특별시 구로구 ,421261,165730,212668,208593
1153051000,11530510,1117051,서울특별시 구로구 신도림동,36617,12835,18190,18427
1153052000,11530520,1117052,서울특별시 구로구 구로제1동,23306,8027,11642,11664
1153053000,11530530,1117053,서울특별시 구로구 구로제2동,16556,7498,8480,8076
1153054000,11530540,1117054,서울특별시 구로구 구로제3동,26432,11989,13391,13041
1153055000,11530550,1117055,서울특별시 구로구 구로제4동,27203,11617,13606,13597
1153056000,11530560,1117056,서울특별시 구로구 구로제5동,32004,12581,16112,15892
1153056500,11530565,1117058,서울특별시 구로구 구로본동,18410,7879,9321,9089
1153059500,11530595,1117070,서울특별시 구로구 가리봉동,15763,8295,8501,7262
1153072000,11530720,1117061,서울특별시 구로구 고척제1동,26401,9676,13371,13030
1153073000,11530730,1117062,서울특별시 구로구 고척제2동,28395,10905,14487,13908
1153074000,11530740,1117063,서울특별시 구로구 개봉제1동,17236,6721,8736,8500
1153075000,11530750,1117064,서울특별시 구로구 개봉제2동,36326,13021,18054,18272
1153076000,11530760,1117065,서울특별시 구로구 개봉제3동,22858,8519,11423,11435
1153076500,11530765,1117066,서울특별시 구로구 개봉본동,20593,8081,10347,10246
1153077000,11530770,1117067,서울특별시 구로구 오류제1동,21050,8100,10577,10473
1153078000,11530780,1117068,서울특별시 구로구 오류제2동,30026,11571,15296,14730
1153079000,11530790,1117069,서울특별시 구로구 수궁동,22085,8415,11134,10951
1154500000,11545000,#N/A,서울특별시 금천구 ,247733,100208,126062,121671
1154551000,11545510,1118051,서울특별시 금천구 가산동,19039,9371,10438,8601
1154561000,11545610,1118052,서울특별시 금천구 독산제1동,31551,12608,16114,15437
1154562000,11545620,1118053,서울특별시 금천구 독산제2동,24219,10046,12308,11911
1154563000,11545630,1118054,서울특별시 금천구 독산제3동,29693,12622,14900,14793
1154564000,11545640,1118055,서울특별시 금천구 독산제4동,19947,8327,10156,9791
1154567000,11545670,1118057,서울특별시 금천구 시흥제1동,32211,13378,16361,15850
1154568000,11545680,1118058,서울특별시 금천구 시흥제2동,26047,8838,12992,13055
1154569000,11545690,1118059,서울특별시 금천구 시흥제3동,13242,4915,6723,6519
1154570000,11545700,1118060,서울특별시 금천구 시흥제4동,25908,10005,13036,12872
1154571000,11545710,1118061,서울특별시 금천구 시흥제5동,25876,10098,13034,12842
1156000000,11560000,#N/A,서울특별시 영등포구 ,408604,168172,206091,202513
1156051500,11560515,1119073,서울특별시 영등포구 영등포본동,26249,11135,13308,12941
1156053500,11560535,1119074,서울특별시 영등포구 영등포동,18137,9338,10088,8049
1156054000,11560540,1119054,서울특별시 영등포구 여의동,33180,12319,16104,17076
1156055000,11560550,1119055,서울특별시 영등포구 당산제1동,20359,8829,10308,10051
1156056000,11560560,1119056,서울특별시 영등포구 당산제2동,32902,12715,16224,16678
1156058500,11560585,1119075,서울특별시 영등포구 도림동,21550,9845,10973,10577
1156060500,11560605,1119076,서울특별시 영등포구 문래동,31798,11680,15918,15880
1156061000,11560610,1119061,서울특별시 영등포구 양평제1동,16931,6919,8574,8357
1156062000,11560620,1119062,서울특별시 영등포구 양평제2동,21625,8012,11024,10601
1156063000,11560630,1119063,서울특별시 영등포구 신길제1동,20939,9692,10555,10384
1156065000,11560650,1119065,서울특별시 영등포구 신길제3동,20287,8198,10215,10072
1156066000,11560660,1119066,서울특별시 영등포구 신길제4동,13997,5851,7061,6936
1156067000,11560670,1119067,서울특별시 영등포구 신길제5동,18199,7771,9238,8961
1156068000,11560680,1119068,서울특별시 영등포구 신길제6동,24790,9737,12334,12456
1156069000,11560690,1119069,서울특별시 영등포구 신길제7동,19749,7564,9927,9822
1156070000,11560700,1119070,서울특별시 영등포구 대림제1동,18145,7696,9150,8995
1156071000,11560710,1119071,서울특별시 영등포구 대림제2동,19262,8600,9649,9613
1156072000,11560720,1119072,서울특별시 영등포구 대림제3동,30505,12271,15441,15064
1159000000,11590000,#N/A,서울특별시 동작구 ,401474,163906,198355,203119
1159051000,11590510,1120072,서울특별시 동작구 노량진제1동,34417,14180,17275,17142
1159052000,11590520,1120052,서울특별시 동작구 노량진제2동,17383,8074,8665,8718
1159053000,11590530,1120053,서울특별시 동작구 상도제1동,39095,16515,19289,19806
1159054000,11590540,1120054,서울특별시 동작구 상도제2동,25423,10555,12534,12889
1159055000,11590550,1120055,서울특별시 동작구 상도제3동,24147,9588,11900,12247
1159056000,11590560,1120056,서울특별시 동작구 상도제4동,29946,11844,14906,15040
1159060500,11590605,1120071,서울특별시 동작구 흑석동,33983,15160,16889,17094
1159062000,11590620,1120063,서울특별시 동작구 사당제1동,23216,10478,11233,11983
1159063000,11590630,1120073,서울특별시 동작구 사당제2동,30650,12418,15044,15606
1159064000,11590640,1120065,서울특별시 동작구 사당제3동,26084,10161,12963,13121
1159065000,11590650,1120066,서울특별시 동작구 사당제4동,14041,5802,6880,7161
1159065100,11590651,1120067,서울특별시 동작구 사당제5동,16054,6394,8026,8028
1159066000,11590660,1120068,서울특별시 동작구 대방동,39425,14637,19345,20080
1159067000,11590670,1120069,서울특별시 동작구 신대방제1동,26868,10155,13257,13611
1159068000,11590680,1120070,서울특별시 동작구 신대방제2동,20742,7945,10149,10593
1162000000,11620000,#N/A,서울특별시 관악구 ,535988,241860,272719,263269
1162052500,11620525,1121052,서울특별시 관악구 보라매동,27401,11502,13746,13655
1162054500,11620545,1121054,서울특별시 관악구 청림동,17773,6893,8781,8992
1162056500,11620565,1121079,서울특별시 관악구 성현동,35605,12950,17752,17853
1162057500,11620575,1121057,서울특별시 관악구 행운동,30366,14813,15257,15109
1162058500,11620585,1121058,서울특별시 관악구 낙성대동,18062,9599,9354,8708
1162059500,11620595,1121080,서울특별시 관악구 청룡동,33975,17525,17138,16837
1162060500,11620605,1121078,서울특별시 관악구 은천동,37262,14877,18701,18561
1162061500,11620615,1121061,서울특별시 관악구 중앙동,14629,7028,7352,7277
1162062500,11620625,1121062,서울특별시 관악구 인헌동,29242,13327,14627,14615
1162063000,11620630,1121063,서울특별시 관악구 남현동,17886,7939,8788,9098
1162064500,11620645,1121064,서울특별시 관악구 서원동,24323,12127,12227,12096
1162065500,11620655,1121065,서울특별시 관악구 신원동,21010,9562,10359,10651
1162066500,11620665,1121066,서울특별시 관악구 서림동,25221,13130,13867,11354
1162068500,11620685,1121068,서울특별시 관악구 신사동,26036,11985,13046,12990
1162069500,11620695,1121069,서울특별시 관악구 신림동,17350,10375,8612,8738
1162071500,11620715,1121071,서울특별시 관악구 난향동,18112,6774,8986,9126
1162072500,11620725,1121072,서울특별시 관악구 조원동,18033,8272,9094,8939
1162073500,11620735,1121073,서울특별시 관악구 대학동,23225,13545,13858,9367
1162074500,11620745,1121082,서울특별시 관악구 삼성동,31964,12773,16250,15714
1162076500,11620765,1121083,서울특별시 관악구 미성동,35617,13639,18068,17549
1162077500,11620775,1121081,서울특별시 관악구 난곡동,32896,13225,16856,16040
1165000000,11650000,#N/A,서울특별시 서초구 ,406030,159701,197464,208566
1165051000,11650510,1122051,서울특별시 서초구 서초1동,20903,8714,10141,10762
1165052000,11650520,1122052,서울특별시 서초구 서초2동,23160,8825,11369,11791
1165053000,11650530,1122053,서울특별시 서초구 서초3동,30215,12170,15248,14967
1165053100,11650531,1122054,서울특별시 서초구 서초4동,28281,9845,13775,14506
1165054000,11650540,1122055,서울특별시 서초구 잠원동,37274,15277,17865,19409
1165055000,11650550,1122056,서울특별시 서초구 반포본동,13579,4566,6421,7158
1165056000,11650560,1122057,서울특별시 서초구 반포1동,18592,9551,8899,9693
1165057000,11650570,1122058,서울특별시 서초구 반포2동,13327,4531,6397,6930
1165058000,11650580,1122059,서울특별시 서초구 반포3동,24561,8786,11828,12733
1165058100,11650581,1122060,서울특별시 서초구 반포4동,20636,7576,9975,10661
1165059000,11650590,1122061,서울특별시 서초구 방배본동,21205,7690,10059,11146
1165060000,11650600,1122062,서울특별시 서초구 방배1동,16460,6621,7930,8530
1165061000,11650610,1122063,서울특별시 서초구 방배2동,28828,11419,14017,14811
1165062000,11650620,1122064,서울특별시 서초구 방배3동,26069,9557,12795,13274
1165062100,11650621,1122065,서울특별시 서초구 방배4동,25856,10159,12255,13601
1165065100,11650651,1122066,서울특별시 서초구 양재1동,27033,11287,13182,13851
1165065200,11650652,1122067,서울특별시 서초구 양재2동,23440,10463,11806,11634
1165066000,11650660,1122068,서울특별시 서초구 내곡동,6611,2664,3502,3109
1168000000,11680000,#N/A,서울특별시 강남구 ,560069,228110,270173,289896
1168051000,11680510,1123051,서울특별시 강남구 신사동,20936,8751,9833,11103
1168052100,11680521,1123052,서울특별시 강남구 논현1동,27243,15166,12649,14594
1168053100,11680531,1123053,서울특별시 강남구 논현2동,24086,11494,11442,12644
1168054000,11680540,1123054,서울특별시 강남구 압구정제1동,17276,6380,8243,9033
1168055000,11680550,1123055,서울특별시 강남구 압구정제2동,12066,4918,5650,6416
1168056000,11680560,1123056,서울특별시 강남구 청담제1동,18008,6641,8724,9284
1168057000,11680570,1123057,서울특별시 강남구 청담제2동,12932,5566,6189,6743
1168058000,11680580,1123058,서울특별시 강남구 삼성1동,15553,6003,7896,7657
1168059000,11680590,1123059,서울특별시 강남구 삼성2동,26096,11426,12499,13597
1168060000,11680600,1123060,서울특별시 강남구 대치1동,26000,7874,12831,13169
1168061000,11680610,1123061,서울특별시 강남구 대치2동,26999,8351,13646,13353
1168062000,11680620,1123062,서울특별시 강남구 대치제3동,18173,6501,9262,8911
1168063000,11680630,1123063,서울특별시 강남구 대치4동,22120,10618,10395,11725
1168064000,11680640,1123064,서울특별시 강남구 역삼1동,35826,20922,17131,18695
1168065000,11680650,1123065,서울특별시 강남구 역삼2동,32246,13433,15192,17054
1168065500,11680655,1123066,서울특별시 강남구 도곡1동,21842,8184,10530,11312
1168065600,11680656,1123067,서울특별시 강남구 도곡2동,33893,12103,16180,17713
1168066000,11680660,1123068,서울특별시 강남구 개포1동,22332,8198,10816,11516
1168067000,11680670,1123069,서울특별시 강남구 개포2동,19339,7782,9300,10039
1168068000,11680680,1123070,서울특별시 강남구 개포제3동,16493,5393,7932,8561
1168069000,11680690,1123071,서울특별시 강남구 개포4동,24337,9748,11968,12369
1168070000,11680700,1123076,서울특별시 강남구 세곡동,5221,2033,2697,2524
1168072000,11680720,1123072,서울특별시 강남구 일원본동,23378,7741,11447,11931
1168073000,11680730,1123073,서울특별시 강남구 일원1동,19676,7768,9734,9942
1168074000,11680740,1123074,서울특별시 강남구 일원2동,20105,7414,9803,10302
1168075000,11680750,1123075,서울특별시 강남구 수서동,17893,7702,8184,9709
1171000000,11710000,#N/A,서울특별시 송파구 ,655040,251014,322585,332455
1171051000,11710510,1124051,서울특별시 송파구 풍납1동,20582,8408,10165,10417
1171052000,11710520,1124052,서울특별시 송파구 풍납2동,29977,11552,14628,15349
1171053100,11710531,1124053,서울특별시 송파구 거여1동,16310,6019,8289,8021
1171053200,11710532,1124054,서울특별시 송파구 거여2동,30690,11827,15555,15135
1171054000,11710540,1124055,서울특별시 송파구 마천1동,19694,8076,10120,9574
1171055000,11710550,1124056,서울특별시 송파구 마천2동,23943,8884,12170,11773
1171056100,11710561,1124057,서울특별시 송파구 방이1동,17498,6245,8690,8808
1171056200,11710562,1124058,서울특별시 송파구 방이2동,26037,11206,12829,13208
1171056600,11710566,1124059,서울특별시 송파구 오륜동,21388,6475,10428,10960
1171057000,11710570,1124060,서울특별시 송파구 오금동,39321,14462,19611,19710
1171058000,11710580,1124061,서울특별시 송파구 송파1동,27900,11669,13538,14362
1171059000,11710590,1124062,서울특별시 송파구 송파2동,22884,7755,11305,11579
1171060000,11710600,1124063,서울특별시 송파구 석촌동,36263,16098,17857,18406
1171061000,11710610,1124064,서울특별시 송파구 삼전동,35274,15669,17010,18264
1171062000,11710620,1124065,서울특별시 송파구 가락본동,30087,11618,15044,15043
1171063100,11710631,1124066,서울특별시 송파구 가락1동,17182,6924,8427,8755
1171063200,11710632,1124067,서울특별시 송파구 가락2동,36577,12623,18135,18442
1171064100,11710641,1124068,서울특별시 송파구 문정1동,22973,8435,11272,11701
1171064200,11710642,1124069,서울특별시 송파구 문정2동,16919,5684,8301,8618
1171064600,11710646,1124070,서울특별시 송파구 장지동,31219,11723,15365,15854
1171065000,11710650,1124071,서울특별시 송파구 잠실본동,31627,14462,15057,16570
1171067000,11710670,1124079,서울특별시 송파구 잠실2동,15274,5598,7431,7843
1171068000,11710680,1124080,서울특별시 송파구 잠실3동,37475,12985,18169,19306
1171069000,11710690,1124075,서울특별시 송파구 잠실4동,20040,7213,9799,10241
1171071000,11710710,1124077,서울특별시 송파구 잠실6동,17128,5885,8262,8866
1171072000,11710720,1124078,서울특별시 송파구 잠실7동,10778,3519,5128,5650
1174000000,11740000,#N/A,서울특별시 강동구 ,466886,177235,234366,232520
1174051500,11740515,1125051,서울특별시 강동구 강일동,527,242,291,236
1174052000,11740520,1125052,서울특별시 강동구 상일동,29780,10143,14954,14826
1174053000,11740530,1125053,서울특별시 강동구 명일제1동,29499,10219,14564,14935
1174054000,11740540,1125054,서울특별시 강동구 명일제2동,19525,6126,9810,9715
1174055000,11740550,1125055,서울특별시 강동구 고덕제1동,21403,7378,10820,10583
1174056000,11740560,1125056,서울특별시 강동구 고덕제2동,20145,7301,10304,9841
1174057000,11740570,1125072,서울특별시 강동구 암사제1동,40061,16043,20102,19959
1174058000,11740580,1125058,서울특별시 강동구 암사제2동,16396,5980,8140,8256
1174059000,11740590,1125059,서울특별시 강동구 암사제3동,12429,4212,6208,6221
1174060000,11740600,1125061,서울특별시 강동구 천호제1동,32737,13017,16518,16219
1174061000,11740610,1125073,서울특별시 강동구 천호제2동,38243,16540,19324,18919
1174062000,11740620,1125063,서울특별시 강동구 천호제3동,29523,13331,14870,14653
1174064000,11740640,1125065,서울특별시 강동구 성내제1동,21557,7857,10763,10794
1174065000,11740650,1125066,서울특별시 강동구 성내제2동,27677,12018,13779,13898
1174066000,11740660,1125067,서울특별시 강동구 성내제3동,25349,10040,12716,12633
1174068500,11740685,1125074,서울특별시 강동구 길동,52703,19927,26182,26521
1174069000,11740690,1125070,서울특별시 강동구 둔촌제1동,21481,6833,11164,10317
1174070000,11740700,1125071,서울특별시 강동구 둔촌제2동,27851,10028,13857,13994
2600000000,26000000,#N/A,부산광역시  ,3568314,1310342,1774921,1793393
2611000000,26110000,#N/A,부산광역시 중구 ,49654,21862,24344,25310
2611051000,26110510,2101051,부산광역시 중구 중앙동,1985,1060,1025,960
2611052000,26110520,2101052,부산광역시 중구 동광동,4027,2083,1967,2060
2611053000,26110530,2101053,부산광역시 중구 대청동,7925,3179,3815,4110
2611054500,26110545,2101054,부산광역시 중구 보수동,12543,5244,6113,6430
2611056000,26110560,2101056,부산광역시 중구 부평동,5297,2483,2541,2756
2611057000,26110570,2101057,부산광역시 중구 광복동,1560,742,785,775
2611058000,26110580,2101058,부산광역시 중구 남포동,1392,718,782,610
2611059000,26110590,2101059,부산광역시 중구 영주제1동,5176,2386,2543,2633
2611060000,26110600,2101060,부산광역시 중구 영주제2동,9749,3967,4773,4976
2614000000,26140000,#N/A,부산광역시 서구 ,129995,51829,64621,65374
2614051000,26140510,2102051,부산광역시 서구 동대신제1동,6232,2439,3067,3165
2614052000,26140520,2102052,부산광역시 서구 동대신제2동,10343,3990,5134,5209
2614053000,26140530,2102053,부산광역시 서구 동대신제3동,8561,3401,4127,4434
2614054000,26140540,2102054,부산광역시 서구 서대신제1동,14043,5537,6885,7158
2614056000,26140560,2102056,부산광역시 서구 서대신제3동,7585,2706,3622,3963
2614057000,26140570,2102057,부산광역시 서구 서대신제4동,8116,2779,4002,4114
2614059000,26140590,2102059,부산광역시 서구 부민동,8123,3149,4049,4074
2614061500,26140615,2102061,부산광역시 서구 아미동,11515,4855,5780,5735
2614063000,26140630,2102063,부산광역시 서구 초장동,7004,2996,3523,3481
2614064000,26140640,2102064,부산광역시 서구 충무동,8706,3836,4344,4362
2614065000,26140650,2102065,부산광역시 서구 남부민제1동,6793,2992,3475,3318
2614066000,26140660,2102066,부산광역시 서구 남부민제2동,7055,2935,3585,3470
2614067000,26140670,2102067,부산광역시 서구 남부민제3동,6132,2544,3105,3027
2614068000,26140680,2102068,부산광역시 서구 암남동,19787,7670,9923,9864
2617000000,26170000,#N/A,부산광역시 동구 ,103175,42204,51672,51503
2617051000,26170510,2103051,부산광역시 동구 초량제1동,5876,2670,2971,2905
2617052000,26170520,2103052,부산광역시 동구 초량제2동,7503,3210,3725,3778
2617053000,26170530,2103053,부산광역시 동구 초량제3동,5826,2667,2960,2866
2617055000,26170550,2103055,부산광역시 동구 초량제6동,9252,3691,4632,4620
2617056000,26170560,2103056,부산광역시 동구 수정제1동,6016,2372,3011,3005
2617057000,26170570,2103057,부산광역시 동구 수정제2동,11313,4648,5631,5682
2617059000,26170590,2103059,부산광역시 동구 수정제4동,6115,2538,3122,2993
2617060000,26170600,2103060,부산광역시 동구 수정제5동,7905,3078,3870,4035
2617061000,26170610,2103061,부산광역시 동구 좌천제1동,8921,3445,4421,4500
2617064000,26170640,2103064,부산광역시 동구 좌천제4동,4818,1854,2436,2382
2617065000,26170650,2103065,부산광역시 동구 범일제1동,5458,2010,2721,2737
2617066000,26170660,2103066,부산광역시 동구 범일제2동,7113,3039,3579,3534
2617067000,26170670,2103067,부산광역시 동구 범일제4동,11343,4494,5687,5656
2617068000,26170680,2103068,부산광역시 동구 범일제5동,5716,2488,2906,2810
2620000000,26200000,#N/A,부산광역시 영도구 ,152704,58017,76287,76417
2620053000,26200530,2104053,부산광역시 영도구 남항동,12579,5252,6505,6074
2620054000,26200540,2104054,부산광역시 영도구 영선제1동,5961,2104,2864,3097
2620055000,26200550,2104055,부산광역시 영도구 영선제2동,12048,4450,6024,6024
2620058500,26200585,2104068,부산광역시 영도구 신선동,15539,6213,7876,7663
2620059000,26200590,2104059,부산광역시 영도구 봉래제1동,8193,3126,4074,4119
2620060500,26200605,2104069,부산광역시 영도구 봉래제2동,10697,4140,5351,5346
2620063000,26200630,2104063,부산광역시 영도구 청학제1동,7977,3176,3999,3978
2620064000,26200640,2104064,부산광역시 영도구 청학제2동,24302,8524,12157,12145
2620065000,26200650,2104065,부산광역시 영도구 동삼제1동,35690,12900,17678,18012
2620066000,26200660,2104066,부산광역시 영도구 동삼제2동,4850,2068,2573,2277
2620067000,26200670,2104067,부산광역시 영도구 동삼제3동,14868,6064,7186,7682
2623000000,26230000,#N/A,부산광역시 부산진구 ,401422,152980,198924,202498
2623051000,26230510,2105051,부산광역시 부산진구 부전제1동,6506,3533,3325,3181
2623052000,26230520,2105052,부산광역시 부산진구 부전제2동,6924,3516,3418,3506
2623053000,26230530,2105053,부산광역시 부산진구 범전동,8666,3802,4329,4337
2623054000,26230540,2105054,부산광역시 부산진구 연지동,22793,8036,11183,11610
2623055000,26230550,2105055,부산광역시 부산진구 초읍동,26635,9889,13057,13578
2623056000,26230560,2105056,부산광역시 부산진구 양정제1동,24559,8669,11988,12571
2623057000,26230570,2105057,부산광역시 부산진구 양정제2동,15381,6516,7598,7783
2623060000,26230600,2105060,부산광역시 부산진구 전포제1동,9972,4268,4908,5064
2623061000,26230610,2105061,부산광역시 부산진구 전포제2동,22178,9143,10856,11322
2623062000,26230620,2105062,부산광역시 부산진구 전포3동,9864,4289,4873,4991
2623064000,26230640,2105064,부산광역시 부산진구 부암제1동,19385,7522,9673,9712
2623066000,26230660,2105066,부산광역시 부산진구 부암제3동,26395,8753,13234,13161
2623067000,26230670,2105067,부산광역시 부산진구 당감제1동,5359,2260,2643,2716
2623068000,26230680,2105068,부산광역시 부산진구 당감제2동,11265,4019,5556,5709
2623069000,26230690,2105069,부산광역시 부산진구 당감제3동,25857,8780,12678,13179
2623070000,26230700,2105070,부산광역시 부산진구 당감제4동,15283,5542,7606,7677
2623071000,26230710,2105071,부산광역시 부산진구 가야제1동,14609,5709,7232,7377
2623072000,26230720,2105072,부산광역시 부산진구 가야제2동,19591,6676,9774,9817
2623073000,26230730,2105073,부산광역시 부산진구 가야제3동,11698,4864,5971,5727
2623074000,26230740,2105074,부산광역시 부산진구 개금제1동,13058,5159,6491,6567
2623075000,26230750,2105075,부산광역시 부산진구 개금제2동,15099,5295,7527,7572
2623076000,26230760,2105076,부산광역시 부산진구 개금제3동,37085,12657,18346,18739
2623077000,26230770,2105077,부산광역시 부산진구 범천제1동,9647,4645,4747,4900
2623078000,26230780,2105078,부산광역시 부산진구 범천제2동,12905,4838,6547,6358
2623079000,26230790,2105079,부산광역시 부산진구 범천제4동,10708,4600,5364,5344
2626000000,26260000,#N/A,부산광역시 동래구 ,282994,100295,140564,142430
2626051000,26260510,2106051,부산광역시 동래구 수민동,33421,11234,16610,16811
2626052000,26260520,2106052,부산광역시 동래구 복산동,14546,5334,7270,7276
2626053000,26260530,2106053,부산광역시 동래구 명륜제1동,5828,2267,2853,2975
2626054000,26260540,2106054,부산광역시 동래구 명륜제2동,8189,3113,4099,4090
2626055000,26260550,2106055,부산광역시 동래구 온천제1동,17670,7988,8464,9206
2626056000,26260560,2106056,부산광역시 동래구 온천제2동,23513,8417,11590,11923
2626057000,26260570,2106057,부산광역시 동래구 온천제3동,36292,12792,17984,18308
2626058000,26260580,2106058,부산광역시 동래구 사직제1동,9688,3454,4781,4907
2626059000,26260590,2106059,부산광역시 동래구 사직제2동,28144,8773,13976,14168
2626060000,26260600,2106060,부산광역시 동래구 사직제3동,17712,6665,8927,8785
2626074000,26260740,2106061,부산광역시 동래구 안락제1동,18339,6716,9212,9127
2626075000,26260750,2106062,부산광역시 동래구 안락제2동,33528,11116,16783,16745
2626076100,26260761,2106063,부산광역시 동래구 명장제1동,18158,6346,9029,9129
2626076200,26260762,2106064,부산광역시 동래구 명장제2동,17966,6080,8986,8980
2629000000,26290000,#N/A,부산광역시 남구 ,297795,109068,148399,149396
2629051000,26290510,2107051,부산광역시 남구 대연제1동,14237,5539,7067,7170
2629052000,26290520,2107052,부산광역시 남구 대연제2동,7986,3210,3974,4012
2629053000,26290530,2107053,부산광역시 남구 대연제3동,29267,11780,14411,14856
2629054000,26290540,2107054,부산광역시 남구 대연제4동,15254,5731,7594,7660
2629055000,26290550,2107055,부산광역시 남구 대연제5동,15922,5735,7807,8115
2629056000,26290560,2107056,부산광역시 남구 대연제6동,12618,4578,6265,6353
2629057000,26290570,2107057,부산광역시 남구 용호제1동,45694,15216,22393,23301
2629058000,26290580,2107058,부산광역시 남구 용호제2동,14290,5162,7145,7145
2629059000,26290590,2107059,부산광역시 남구 용호제3동,16404,5850,8171,8233
2629060000,26290600,2107060,부산광역시 남구 용호제4동,9383,3394,4705,4678
2629061000,26290610,2107061,부산광역시 남구 용당동,9636,3358,4918,4718
2629062000,26290620,2107062,부산광역시 남구 감만제1동,19371,6960,9931,9440
2629063000,26290630,2107063,부산광역시 남구 감만제2동,8842,3349,4485,4357
2629064000,26290640,2107064,부산광역시 남구 우암제1동,15748,5383,7959,7789
2629065000,26290650,2107065,부산광역시 남구 우암제2동,6804,2814,3426,3378
2629068000,26290680,2107066,부산광역시 남구 문현제1동,18206,6404,9135,9071
2629069000,26290690,2107067,부산광역시 남구 문현제2동,10159,4326,5148,5011
2629070000,26290700,2107068,부산광역시 남구 문현제3동,15119,5361,7409,7710
2629071000,26290710,2107069,부산광역시 남구 문현제4동,12855,4918,6456,6399
2632000000,26320000,#N/A,부산광역시 북구 ,319592,110634,159680,159912
2632051000,26320510,2108051,부산광역시 북구 구포제1동,15018,6140,7553,7465
2632052000,26320520,2108052,부산광역시 북구 구포제2동,31652,11464,16236,15416
2632052100,26320521,2108053,부산광역시 북구 구포제3동,27857,9680,14241,13616
2632053000,26320530,2108054,부산광역시 북구 금곡동,45587,16595,22258,23329
2632054100,26320541,2108055,부산광역시 북구 화명제1동,29367,8992,14609,14758
2632054200,26320542,2108062,부산광역시 북구 화명제2동,21755,6948,10925,10830
2632054300,26320543,2108063,부산광역시 북구 화명제3동,35166,10485,17329,17837
2632055000,26320550,2108056,부산광역시 북구 덕천제1동,18807,7367,9376,9431
2632056000,26320560,2108057,부산광역시 북구 덕천제2동,16768,6502,8432,8336
2632056100,26320561,2108058,부산광역시 북구 덕천제3동,14488,5517,7118,7370
2632057100,26320571,2108059,부산광역시 북구 만덕제1동,14823,5177,7472,7351
2632057200,26320572,2108060,부산광역시 북구 만덕제2동,24318,8208,12178,12140
2632057300,26320573,2108061,부산광역시 북구 만덕제3동,23986,7559,11953,12033
2635000000,26350000,#N/A,부산광역시 해운대구 ,425124,150798,208634,216490
2635051000,26350510,2109051,부산광역시 해운대구 우제1동,41281,15157,20012,21269
2635052000,26350520,2109052,부산광역시 해운대구 우제2동,24888,8573,12109,12779
2635053000,26350530,2109053,부산광역시 해운대구 중제1동,21280,8520,10308,10972
2635054000,26350540,2109054,부산광역시 해운대구 중제2동,11954,5321,5772,6182
2635055100,26350551,2109066,부산광역시 해운대구 좌제1동,18534,6267,8890,9644
2635055200,26350552,2109067,부산광역시 해운대구 좌제2동,36098,12306,17344,18754
2635055300,26350553,2109068,부산광역시 해운대구 좌제3동,19864,6425,9619,10245
2635055400,26350554,2109069,부산광역시 해운대구 좌제4동,27366,8630,13246,14120
2635056000,26350560,2109056,부산광역시 해운대구 송정동,7769,3185,3845,3924
2635057000,26350570,2109070,부산광역시 해운대구 반여제1동,44305,14212,21981,22324
2635058000,26350580,2109058,부산광역시 해운대구 반여제2동,18768,7349,9270,9498
2635059000,26350590,2109059,부산광역시 해운대구 반여제3동,13658,5185,6871,6787
2635059500,26350595,2109071,부산광역시 해운대구 반여제4동,18411,5589,9215,9196
2635061000,26350610,2109061,부산광역시 해운대구 반송제1동,12286,5036,6288,5998
2635062000,26350620,2109062,부산광역시 해운대구 반송제2동,33845,12664,16676,17169
2635063000,26350630,2109063,부산광역시 해운대구 반송제3동,10561,4175,5238,5323
2635065000,26350650,2109064,부산광역시 해운대구 재송제1동,31639,10537,15741,15898
2635066000,26350660,2109065,부산광역시 해운대구 재송제2동,32617,11667,16209,16408
2638000000,26380000,#N/A,부산광역시 사하구 ,365842,130017,183078,182764
2638051000,26380510,2110051,부산광역시 사하구 괴정제1동,22479,7829,11081,11398
2638052000,26380520,2110052,부산광역시 사하구 괴정제2동,17900,6361,8824,9076
2638053000,26380530,2110053,부산광역시 사하구 괴정제3동,15023,5786,7246,7777
2638054000,26380540,2110054,부산광역시 사하구 괴정제4동,17298,6265,8613,8685
2638055000,26380550,2110055,부산광역시 사하구 당리동,30816,10375,15265,15551
2638056100,26380561,2110056,부산광역시 사하구 하단제1동,24807,8431,12350,12457
2638056200,26380562,2110057,부산광역시 사하구 하단제2동,29006,10491,14507,14499
2638057100,26380571,2110058,부산광역시 사하구 신평제1동,20290,7978,10370,9920
2638057200,26380572,2110059,부산광역시 사하구 신평제2동,17643,5935,8836,8807
2638058000,26380580,2110060,부산광역시 사하구 장림제1동,15369,6018,7920,7449
2638059000,26380590,2110061,부산광역시 사하구 장림제2동,31566,10760,16029,15537
2638060100,26380601,2110062,부산광역시 사하구 다대제1동,45252,16122,22713,22539
2638060200,26380602,2110063,부산광역시 사하구 다대제2동,32708,11556,16196,16512
2638061000,26380610,2110064,부산광역시 사하구 구평동,7307,2541,3739,3568
2638062000,26380620,2110065,부산광역시 사하구 감천제1동,27272,9216,13624,13648
2638063000,26380630,2110066,부산광역시 사하구 감천제2동,11106,4353,5765,5341
2641000000,26410000,#N/A,부산광역시 금정구 ,256855,93106,127002,129853
2641051000,26410510,2111051,부산광역시 금정구 서제1동,10577,4339,5299,5278
2641052000,26410520,2111052,부산광역시 금정구 서제2동,14597,5705,7285,7312
2641053000,26410530,2111053,부산광역시 금정구 서제3동,8043,2908,4095,3948
2641054000,26410540,2111054,부산광역시 금정구 서제4동,7460,2942,3671,3789
2641055000,26410550,2111055,부산광역시 금정구 금사동,11462,4408,5993,5469
2641057000,26410570,2111057,부산광역시 금정구 부곡제1동,12266,4764,5999,6267
2641058000,26410580,2111058,부산광역시 금정구 부곡제2동,17728,6250,8816,8912
2641059000,26410590,2111059,부산광역시 금정구 부곡제3동,19283,6472,9337,9946
2641059100,26410591,2111060,부산광역시 금정구 부곡제4동,16828,6233,8367,8461
2641060000,26410600,2111061,부산광역시 금정구 장전제1동,14705,6146,7267,7438
2641061000,26410610,2111062,부산광역시 금정구 장전제2동,7239,2491,3357,3882
2641062000,26410620,2111063,부산광역시 금정구 장전제3동,9263,3819,4579,4684
2641063500,26410635,2111064,부산광역시 금정구 선두구동,3012,1246,1580,1432
2641066500,26410665,2111067,부산광역시 금정구 청룡노포동,10277,3703,5217,5060
2641067000,26410670,2111068,부산광역시 금정구 남산동,37106,13005,18214,18892
2641068000,26410680,2111069,부산광역시 금정구 구서제1동,17462,6015,8489,8973
2641069000,26410690,2111070,부산광역시 금정구 구서제2동,38361,12210,18868,19493
2641070000,26410700,2111071,부산광역시 금정구 금성동,1186,450,569,617
2644000000,26440000,#N/A,부산광역시 강서구 ,51404,21818,27073,24331
2644051000,26440510,2112051,부산광역시 강서구 대저1동,11808,5065,6199,5609
2644052000,26440520,2112052,부산광역시 강서구 대저2동,8943,3551,4709,4234
2644053000,26440530,2112053,부산광역시 강서구 강동동,7743,3256,4034,3709
2644054000,26440540,2112054,부산광역시 강서구 명지동,8294,3234,4285,4009
2644055000,26440550,2112055,부산광역시 강서구 가락동,3199,1396,1668,1531
2644056000,26440560,2112056,부산광역시 강서구 녹산동,8429,3880,4580,3849
2644057000,26440570,2112057,부산광역시 강서구 천가동,2988,1436,1598,1390
2647000000,26470000,#N/A,부산광역시 연제구 ,212865,77228,105233,107632
2647061000,26470610,2113051,부산광역시 연제구 거제제1동,31622,10521,15527,16095
2647062000,26470620,2113052,부산광역시 연제구 거제제2동,15863,5643,7937,7926
2647063000,26470630,2113053,부산광역시 연제구 거제제3동,12505,4537,6124,6381
2647064000,26470640,2113054,부산광역시 연제구 거제제4동,11868,3985,5893,5975
2647065000,26470650,2113055,부산광역시 연제구 연산제1동,12947,4619,6441,6506
2647066000,26470660,2113056,부산광역시 연제구 연산제2동,15694,6271,7689,8005
2647067000,26470670,2113057,부산광역시 연제구 연산제3동,12704,5034,6262,6442
2647068000,26470680,2113058,부산광역시 연제구 연산제4동,18537,7171,9251,9286
2647069000,26470690,2113059,부산광역시 연제구 연산제5동,10831,4514,5287,5544
2647070000,26470700,2113060,부산광역시 연제구 연산제6동,18260,7081,9055,9205
2647072000,26470720,2113062,부산광역시 연제구 연산제8동,11667,4430,5882,5785
2647073000,26470730,2113063,부산광역시 연제구 연산제9동,40367,13422,19885,20482
2650000000,26500000,#N/A,부산광역시 수영구 ,177532,65957,86239,91293
2650066000,26500660,2114051,부산광역시 수영구 남천제1동,14599,5433,6965,7634
2650067000,26500670,2114052,부산광역시 수영구 남천제2동,12407,4524,5836,6571
2650073000,26500730,2114053,부산광역시 수영구 수영동,16610,6539,8101,8509
2650074000,26500740,2114054,부산광역시 수영구 망미제1동,30754,10857,15088,15666
2650075000,26500750,2114055,부산광역시 수영구 망미제2동,14913,5408,7427,7486
2650076000,26500760,2114056,부산광역시 수영구 광안제1동,24138,8743,11771,12367
2650077000,26500770,2114057,부산광역시 수영구 광안제2동,16589,6424,8006,8583
2650078000,26500780,2114058,부산광역시 수영구 광안제3동,10369,4101,5093,5276
2650079000,26500790,2114059,부산광역시 수영구 광안제4동,15067,5419,7098,7969
2650080000,26500800,2114060,부산광역시 수영구 민락동,22086,8509,10854,11232
2653000000,26530000,#N/A,부산광역시 사상구 ,261652,93524,133162,128490
2653058000,26530580,2115051,부산광역시 사상구 삼락동,9025,3660,4807,4218
2653059100,26530591,2115052,부산광역시 사상구 모라제1동,35262,11984,17771,17491
2653059300,26530593,2115054,부산광역시 사상구 모라제3동,16543,6909,7967,8576
2653060000,26530600,2115055,부산광역시 사상구 덕포제1동,13022,4989,6691,6331
2653061000,26530610,2115056,부산광역시 사상구 덕포제2동,16910,5792,8631,8279
2653062000,26530620,2115057,부산광역시 사상구 괘법동,22796,8979,11766,11030
2653064500,26530645,2115065,부산광역시 사상구 감전동,16768,6770,8894,7874
2653065000,26530650,2115060,부산광역시 사상구 주례제1동,18992,6530,9649,9343
2653066000,26530660,2115061,부산광역시 사상구 주례제2동,28062,9890,14148,13914
2653066100,26530661,2115062,부산광역시 사상구 주례제3동,17232,5846,8716,8516
2653067000,26530670,2115063,부산광역시 사상구 학장동,36989,12251,18734,18255
2653068000,26530680,2115064,부산광역시 사상구 엄궁동,30051,9924,15388,14663
2671000000,26710000,#N/A,부산광역시 기장군 ,79709,31005,40009,39700
2671025000,26710250,2131011,부산광역시 기장군 기장읍,49998,18934,24705,25293
2671025300,26710253,2131012,부산광역시 기장군 장안읍,10610,4336,5456,5154
2671031000,26710310,2131031,부산광역시 기장군 일광면,9195,3840,4630,4565
2671032000,26710320,2131032,부산광역시 기장군 정관면,4988,1901,2603,2385
2671033000,26710330,2131033,부산광역시 기장군 철마면,4918,1994,2615,2303
2700000000,27000000,#N/A,대구광역시  ,2493479,892849,1247017,1246462
2711000000,27110000,#N/A,대구광역시 중구 ,77561,33681,38243,39318
2711051500,27110515,2201051,대구광역시 중구 동인1.2.4가동,5805,2693,2901,2904
2711052000,27110520,2201052,대구광역시 중구 동인3가동,4956,2209,2460,2496
2711054500,27110545,2201054,대구광역시 중구 삼덕동,5134,2582,2470,2664
2711056500,27110565,2201056,대구광역시 중구 성내1동,4748,2272,2374,2374
2711057500,27110575,2201059,대구광역시 중구 성내2동,5368,2576,2757,2611
2711058500,27110585,2201061,대구광역시 중구 성내3동,4754,2225,2406,2348
2711059500,27110595,2201062,대구광역시 중구 대신동,5805,2281,2934,2871
2711064000,27110640,2201064,대구광역시 중구 남산1동,4701,2184,2348,2353
2711065000,27110650,2201065,대구광역시 중구 남산2동,5432,2381,2657,2775
2711066000,27110660,2201066,대구광역시 중구 남산3동,5896,2306,2738,3158
2711067000,27110670,2201067,대구광역시 중구 남산4동,12490,4742,6179,6311
2711068000,27110680,2201068,대구광역시 중구 대봉1동,7979,3265,3832,4147
2711069000,27110690,2201069,대구광역시 중구 대봉2동,4493,1965,2187,2306
2714000000,27140000,#N/A,대구광역시 동구 ,330824,124764,165937,164887
2714051000,27140510,2202051,대구광역시 동구 신암1동,15179,6134,7564,7615
2714052000,27140520,2202052,대구광역시 동구 신암2동,9946,3741,4890,5056
2714053000,27140530,2202053,대구광역시 동구 신암3동,11203,4617,5599,5604
2714054000,27140540,2202054,대구광역시 동구 신암4동,20684,8655,10348,10336
2714054100,27140541,2202055,대구광역시 동구 신암5동,10281,3799,5119,5162
2714055500,27140555,2202056,대구광역시 동구 신천1.2동,13096,5027,6547,6549
2714057000,27140570,2202058,대구광역시 동구 신천3동,10528,4144,5358,5170
2714058000,27140580,2202059,대구광역시 동구 신천4동,10739,4586,5414,5325
2714059000,27140590,2202060,대구광역시 동구 효목1동,19003,7388,9621,9382
2714060000,27140600,2202061,대구광역시 동구 효목2동,19397,7305,9613,9784
2714061500,27140615,2202062,대구광역시 동구 도평동,6461,2355,3338,3123
2714062000,27140620,2202063,대구광역시 동구 불로.봉무동,15425,5753,7742,7683
2714064000,27140640,2202065,대구광역시 동구 지저동,12742,4829,6501,6241
2714065500,27140655,2202066,대구광역시 동구 동촌동,15631,6022,7931,7700
2714067000,27140670,2202068,대구광역시 동구 방촌동,22741,7796,11321,11420
2714068500,27140685,2202069,대구광역시 동구 해안동,20025,7334,10080,9945
2714072000,27140720,2202073,대구광역시 동구 안심1동,24845,9725,12397,12448
2714073000,27140730,2202074,대구광역시 동구 안심2동,12177,4419,6206,5971
2714074500,27140745,2202075,대구광역시 동구 안심3.4동,43122,14617,21529,21593
2714076000,27140760,2202071,대구광역시 동구 공산동,17599,6518,8819,8780
2717000000,27170000,#N/A,대구광역시 서구 ,231161,87982,117517,113644
2717051000,27170510,2203051,대구광역시 서구 내당1동,13032,4867,6393,6639
2717052500,27170525,2203052,대구광역시 서구 내당2.3동,14062,5469,6983,7079
2717054000,27170540,2203053,대구광역시 서구 내당4동,20880,7389,10282,10598
2717055000,27170550,2203054,대구광역시 서구 비산1동,15369,5781,7906,7463
2717056500,27170565,2203055,대구광역시 서구 비산2.3동,14833,5993,7515,7318
2717058000,27170580,2203056,대구광역시 서구 비산4동,13168,4831,6525,6643
2717059000,27170590,2203057,대구광역시 서구 비산5동,9340,3736,4809,4531
2717060000,27170600,2203058,대구광역시 서구 비산6동,10778,4073,5397,5381
2717061000,27170610,2203059,대구광역시 서구 비산7동,15779,6510,8290,7489
2717062000,27170620,2203060,대구광역시 서구 평리1동,11022,4176,5656,5366
2717063000,27170630,2203061,대구광역시 서구 평리2동,6650,2528,3313,3337
2717064000,27170640,2203062,대구광역시 서구 평리3동,16623,6459,8523,8100
2717065000,27170650,2203063,대구광역시 서구 평리4동,16575,6380,8433,8142
2717066000,27170660,2203064,대구광역시 서구 평리5동,9406,3517,4818,4588
2717066100,27170661,2203065,대구광역시 서구 평리6동,11415,4148,6059,5356
2717067500,27170675,2203066,대구광역시 서구 상중이동,19111,6876,9887,9224
2717069500,27170695,2203068,대구광역시 서구 원대동,13118,5249,6728,6390
2720000000,27200000,#N/A,대구광역시 남구 ,176832,72711,86405,90427
2720051500,27200515,2204051,대구광역시 남구 이천동,16535,6582,8069,8466
2720053000,27200530,2204053,대구광역시 남구 봉덕1동,8909,4206,4310,4599
2720054000,27200540,2204054,대구광역시 남구 봉덕2동,12500,4928,6095,6405
2720055000,27200550,2204055,대구광역시 남구 봉덕3동,19623,7875,9416,10207
2720056000,27200560,2204056,대구광역시 남구 대명1동,12833,5009,6187,6646
2720057100,27200571,2204057,대구광역시 남구 대명2동,14931,6564,7258,7673
2720058600,27200586,2204058,대구광역시 남구 대명3동,16561,7079,8332,8229
2720059000,27200590,2204059,대구광역시 남구 대명4동,14580,5850,7301,7279
2720060000,27200600,2204060,대구광역시 남구 대명5동,10063,4468,4873,5190
2720061000,27200610,2204061,대구광역시 남구 대명6동,10916,4342,5313,5603
2720064000,27200640,2204064,대구광역시 남구 대명9동,17075,6912,8292,8783
2720065000,27200650,2204065,대구광역시 남구 대명10동,11229,4407,5441,5788
2720066000,27200660,2204066,대구광역시 남구 대명11동,11077,4489,5518,5559
2723000000,27230000,#N/A,대구광역시 북구 ,461839,159811,232190,229649
2723051000,27230510,2205051,대구광역시 북구 고성동,8297,3391,4180,4117
2723052600,27230526,2205052,대구광역시 북구 칠성동,18601,6908,9293,9308
2723055000,27230550,2205055,대구광역시 북구 침산1동,6757,2549,3567,3190
2723056000,27230560,2205056,대구광역시 북구 침산2동,17256,5615,8603,8653
2723057000,27230570,2205057,대구광역시 북구 침산3동,21991,7001,10872,11119
2723058500,27230585,2205058,대구광역시 북구 노원1.2동,10942,4048,5645,5297
2723059500,27230595,2205059,대구광역시 북구 노원3동,5003,2212,2709,2294
2723061000,27230610,2205061,대구광역시 북구 산격1동,14548,5918,7258,7290
2723062000,27230620,2205062,대구광역시 북구 산격2동,13520,4472,6804,6716
2723063000,27230630,2205063,대구광역시 북구 산격3동,11173,4628,5576,5597
2723063100,27230631,2205064,대구광역시 북구 산격4동,11915,4574,6037,5878
2723064000,27230640,2205067,대구광역시 북구 대현1동,7802,3244,3947,3855
2723065000,27230650,2205068,대구광역시 북구 대현2동,9847,3835,4940,4907
2723067100,27230671,2205065,대구광역시 북구 복현1동,8507,3539,4347,4160
2723067200,27230672,2205066,대구광역시 북구 복현2동,28908,9465,14432,14476
2723068000,27230680,2205070,대구광역시 북구 검단동,9885,3468,5124,4761
2723069500,27230695,2205071,대구광역시 북구 무태조야동,34068,11796,17374,16694
2723071500,27230715,2205075,대구광역시 북구 관문동,17141,5692,8653,8488
2723072500,27230725,2205078,대구광역시 북구 태전1동,25838,8880,13115,12723
2723073500,27230735,2205074,대구광역시 북구 태전2동,22827,7697,11414,11413
2723074500,27230745,2205079,대구광역시 북구 구암동,44384,13844,22183,22201
2723075000,27230750,2205077,대구광역시 북구 관음동,23949,8031,12058,11891
2723077000,27230770,2205076,대구광역시 북구 읍내동,28348,9505,14119,14229
2723078000,27230780,2205080,대구광역시 북구 동천동,60332,19499,29940,30392
2726000000,27260000,#N/A,대구광역시 수성구 ,452778,153535,223463,229315
2726051000,27260510,2206051,대구광역시 수성구 범어1동,16912,5755,8320,8592
2726052000,27260520,2206052,대구광역시 수성구 범어2동,10639,4006,5302,5337
2726053000,27260530,2206053,대구광역시 수성구 범어3동,8663,3044,4227,4436
2726054000,27260540,2206054,대구광역시 수성구 범어4동,19877,6076,9897,9980
2726055000,27260550,2206055,대구광역시 수성구 만촌1동,26585,8680,13292,13293
2726056000,27260560,2206056,대구광역시 수성구 만촌2동,14702,5125,7418,7284
2726056100,27260561,2206057,대구광역시 수성구 만촌3동,23446,7325,12019,11427
2726057000,27260570,2206058,대구광역시 수성구 수성1가동,19571,6778,9443,10128
2726058000,27260580,2206059,대구광역시 수성구 수성2.3가동,7871,3113,3919,3952
2726059000,27260590,2206060,대구광역시 수성구 수성4가동,17241,5906,8383,8858
2726060100,27260601,2206061,대구광역시 수성구 황금1동,26493,8139,13125,13368
2726060200,27260602,2206062,대구광역시 수성구 황금2동,14010,5387,6926,7084
2726061000,27260610,2206063,대구광역시 수성구 중동,14471,6020,7143,7328
2726062000,27260620,2206064,대구광역시 수성구 상동,15603,6259,7553,8050
2726063000,27260630,2206065,대구광역시 수성구 파동,15107,5410,7614,7493
2726064000,27260640,2206066,대구광역시 수성구 두산동,11439,4773,5587,5852
2726065100,27260651,2206067,대구광역시 수성구 지산1동,28253,10165,13775,14478
2726065200,27260652,2206068,대구광역시 수성구 지산2동,25202,8532,12225,12977
2726066100,27260661,2206069,대구광역시 수성구 범물1동,16170,6048,7648,8522
2726066200,27260662,2206070,대구광역시 수성구 범물2동,20007,6416,9918,10089
2726067000,27260670,2206071,대구광역시 수성구 고산1동,35492,10582,17502,17990
2726068000,27260680,2206072,대구광역시 수성구 고산2동,29081,9017,14508,14573
2726069000,27260690,2206073,대구광역시 수성구 고산3동,35943,10979,17719,18224
2729000000,27290000,#N/A,대구광역시 달서구 ,595313,202193,297715,297598
2729051000,27290510,2207051,대구광역시 달서구 성당1동,9734,4165,4809,4925
2729052000,27290520,2207052,대구광역시 달서구 성당2동,15623,5573,7729,7894
2729053000,27290530,2207053,대구광역시 달서구 두류1동,7263,2909,3692,3571
2729054000,27290540,2207054,대구광역시 달서구 두류2동,12641,5213,6386,6255
2729055000,27290550,2207055,대구광역시 달서구 두류3동,12047,4291,5945,6102
2729055500,27290555,2207057,대구광역시 달서구 감삼동,26858,9060,13385,13473
2729056300,27290563,2207058,대구광역시 달서구 죽전동,18472,6635,9283,9189
2729056800,27290568,2207059,대구광역시 달서구 장기동,19843,6565,9878,9965
2729057100,27290571,2207072,대구광역시 달서구 용산1동,36896,11611,18583,18313
2729057200,27290572,2207073,대구광역시 달서구 용산2동,36460,11322,18504,17956
2729057600,27290576,2207060,대구광역시 달서구 이곡1동,29073,9037,14692,14381
2729057700,27290577,2207074,대구광역시 달서구 이곡2동,21316,6675,10808,10508
2729058500,27290585,2207061,대구광역시 달서구 신당동,42770,16391,21362,21408
2729059000,27290590,2207056,대구광역시 달서구 본리동,19267,6905,9703,9564
2729060100,27290601,2207062,대구광역시 달서구 월성1동,25734,7557,12940,12794
2729060200,27290602,2207063,대구광역시 달서구 월성2동,23024,8646,11354,11670
2729061500,27290615,2207064,대구광역시 달서구 진천동,50975,16230,25595,25380
2729062400,27290624,2207065,대구광역시 달서구 상인1동,34709,10427,17305,17404
2729062500,27290625,2207066,대구광역시 달서구 상인2동,24878,8493,12420,12458
2729062600,27290626,2207067,대구광역시 달서구 상인3동,17189,6349,8428,8761
2729062800,27290628,2207068,대구광역시 달서구 도원동,44471,13366,22136,22335
2729063000,27290630,2207069,대구광역시 달서구 송현1동,24471,9462,12277,12194
2729064000,27290640,2207070,대구광역시 달서구 송현2동,24597,9228,11975,12622
2729065000,27290650,2207071,대구광역시 달서구 본동,17002,6083,8526,8476
2771000000,27710000,#N/A,대구광역시 달성군 ,167171,58172,85547,81624
2771025000,27710250,2231011,대구광역시 달성군 화원읍,58266,18785,29549,28717
2771025300,27710253,2231012,대구광역시 달성군 논공읍,24456,8877,12763,11693
2771025600,27710256,2231013,대구광역시 달성군 다사읍,40131,13082,20322,19809
2771031000,27710310,2231031,대구광역시 달성군 가창면,9213,3609,4654,4559
2771033000,27710330,2231032,대구광역시 달성군 하빈면,4581,1915,2504,2077
2771034000,27710340,2231033,대구광역시 달성군 옥포면,10890,4024,5730,5160
2771036000,27710360,2231034,대구광역시 달성군 현풍면,11155,4230,5664,5491
2771037000,27710370,2231035,대구광역시 달성군 유가면,4125,1697,2111,2014
2771038000,27710380,2231036,대구광역시 달성군 구지면,4354,1953,2250,2104
2800000000,28000000,#N/A,인천광역시  ,2689737,1013104,1354928,1334809
2811000000,28110000,#N/A,인천광역시 중구 ,88592,38906,45670,42922
2811052000,28110520,2301052,인천광역시 중구 연안동,8748,3864,4609,4139
2811053000,28110530,2301053,인천광역시 중구 신포동,6427,2935,3262,3165
2811054000,28110540,2301054,인천광역시 중구 신흥동,16535,6885,8395,8140
2811056000,28110560,2301056,인천광역시 중구 도원동,5438,2287,2771,2667
2811057000,28110570,2301057,인천광역시 중구 율목동,5018,2165,2583,2435
2811058500,28110585,2301058,인천광역시 중구 동인천동,6853,3109,3538,3315
2811060000,28110600,2301060,인천광역시 중구 북성동,4565,2158,2280,2285
2811061000,28110610,2301061,인천광역시 중구 송월동,6326,2626,3159,3167
2811062000,28110620,2301062,인천광역시 중구 영종동,23994,10442,12584,11410
2811063000,28110630,2301063,인천광역시 중구 용유동,4688,2435,2489,2199
2814000000,28140000,#N/A,인천광역시 동구 ,73074,29273,36890,36184
2814051000,28140510,2302051,인천광역시 동구 만석동,8581,3425,4406,4175
2814052500,28140525,2302052,인천광역시 동구 화수1.화평동,8299,3326,4164,4135
2814053000,28140530,2302053,인천광역시 동구 화수2동,10469,4136,5244,5225
2814055500,28140555,2302055,인천광역시 동구 송현1.2동,13567,4885,6742,6825
2814057000,28140570,2302057,인천광역시 동구 송현3동,5215,2142,2644,2571
2814058000,28140580,2302058,인천광역시 동구 송림1동,3281,1319,1623,1658
2814059000,28140590,2302059,인천광역시 동구 송림2동,4273,1821,2151,2122
2814060500,28140605,2302060,인천광역시 동구 송림3.5동,7471,3128,3785,3686
2814061000,28140610,2302061,인천광역시 동구 송림4동,2908,1281,1573,1335
2814063000,28140630,2302063,인천광역시 동구 송림6동,4582,1920,2336,2246
2814064000,28140640,2302064,인천광역시 동구 금창동,4428,1890,2222,2206
2817000000,28170000,#N/A,인천광역시 남구 ,420541,167967,212788,207753
2817051000,28170510,2303051,인천광역시 남구 숭의1동,6546,3045,3372,3174
2817052000,28170520,2303052,인천광역시 남구 숭의2동,10265,4488,5195,5070
2817053000,28170530,2303053,인천광역시 남구 숭의3동,6799,2875,3456,3343
2817054000,28170540,2303054,인천광역시 남구 숭의4동,16776,6806,8419,8357
2817055000,28170550,2303055,인천광역시 남구 용현1동,15004,6461,7851,7153
2817056000,28170560,2303056,인천광역시 남구 용현2동,15843,6264,8050,7793
2817057000,28170570,2303057,인천광역시 남구 용현3동,10282,4627,5380,4902
2817058000,28170580,2303058,인천광역시 남구 용현4동,6857,3377,3775,3082
2817059000,28170590,2303059,인천광역시 남구 용현5동,36205,13005,18187,18018
2817060000,28170600,2303060,인천광역시 남구 학익1동,34543,12164,17413,17130
2817061000,28170610,2303061,인천광역시 남구 학익2동,23227,8362,11593,11634
2817063000,28170630,2303062,인천광역시 남구 도화1동,20278,8340,10152,10126
2817064000,28170640,2303063,인천광역시 남구 도화2동,17739,7556,9101,8638
2817065000,28170650,2303064,인천광역시 남구 도화3동,7434,3039,3930,3504
2817066000,28170660,2303065,인천광역시 남구 주안1동,10648,5351,5490,5158
2817067000,28170670,2303066,인천광역시 남구 주안2동,26508,10929,13334,13174
2817068000,28170680,2303067,인천광역시 남구 주안3동,12778,4917,6473,6305
2817069000,28170690,2303068,인천광역시 남구 주안4동,25525,10413,12774,12751
2817070000,28170700,2303069,인천광역시 남구 주안5동,24388,9738,12385,12003
2817071000,28170710,2303070,인천광역시 남구 주안6동,20057,8144,10100,9957
2817072000,28170720,2303071,인천광역시 남구 주안7동,17211,6594,8612,8599
2817073000,28170730,2303072,인천광역시 남구 주안8동,21811,8108,10865,10946
2817073500,28170735,2303073,인천광역시 남구 관교동,18042,6300,8829,9213
2817074000,28170740,2303074,인천광역시 남구 문학동,15775,7064,8052,7723
2818500000,28185000,#N/A,인천광역시 연수구 ,268547,95015,134705,133842
2818563000,28185630,2304051,인천광역시 연수구 옥련1동,23910,8253,11919,11991
2818564000,28185640,2304060,인천광역시 연수구 옥련2동,25272,8494,12615,12657
2818575000,28185750,2304052,인천광역시 연수구 선학동,22184,8526,11234,10950
2818576100,28185761,2304053,인천광역시 연수구 연수1동,28012,11738,14678,13334
2818576200,28185762,2304054,인천광역시 연수구 연수2동,25757,9870,12760,12997
2818576300,28185763,2304055,인천광역시 연수구 연수3동,21810,7794,10640,11170
2818576600,28185766,2304056,인천광역시 연수구 청학동,32225,12747,16584,15641
2818578000,28185780,2304057,인천광역시 연수구 동춘1동,18988,6154,9321,9667
2818579000,28185790,2304058,인천광역시 연수구 동춘2동,23039,7262,11493,11546
2818579500,28185795,2304059,인천광역시 연수구 동춘3동,20921,6121,10364,10557
2818581000,28185810,2304061,인천광역시 연수구 송도동,26429,8056,13097,13332
2820000000,28200000,#N/A,인천광역시 남동구 ,448203,167681,224257,223946
2820051000,28200510,2305051,인천광역시 남동구 구월1동,27530,11862,13861,13669
2820052000,28200520,2305052,인천광역시 남동구 구월2동,42758,14144,21192,21566
2820052100,28200521,2305053,인천광역시 남동구 구월3동,13972,5710,7003,6969
2820052200,28200522,2305054,인천광역시 남동구 구월4동,21166,8604,10691,10475
2820053000,28200530,2305055,인천광역시 남동구 간석1동,26998,10967,13461,13537
2820054000,28200540,2305056,인천광역시 남동구 간석2동,20300,7211,10058,10242
2820055000,28200550,2305057,인천광역시 남동구 간석3동,29962,12586,15128,14834
2820055100,28200551,2305058,인천광역시 남동구 간석4동,30661,11861,15381,15280
2820056000,28200560,2305059,인천광역시 남동구 만수1동,21195,8466,10528,10667
2820057000,28200570,2305060,인천광역시 남동구 만수2동,20241,7221,10146,10095
2820058000,28200580,2305061,인천광역시 남동구 만수3동,21598,7557,10921,10677
2820058100,28200581,2305062,인천광역시 남동구 만수4동,24065,8460,12028,12037
2820058200,28200582,2305063,인천광역시 남동구 만수5동,20644,7972,10365,10279
2820058300,28200583,2305064,인천광역시 남동구 만수6동,30713,10598,15105,15608
2820065000,28200650,2305065,인천광역시 남동구 장수서창동,15044,5069,7508,7536
2820066000,28200660,2305067,인천광역시 남동구 남촌도림동,24952,9052,12732,12220
2820067000,28200670,2305069,인천광역시 남동구 논현고잔동,56404,20341,28149,28255
2823700000,28237000,#N/A,인천광역시 부평구 ,569098,210696,285355,283743
2823751000,28237510,2306051,인천광역시 부평구 부평1동,35314,12913,17226,18088
2823752000,28237520,2306052,인천광역시 부평구 부평2동,23674,9533,11859,11815
2823753000,28237530,2306053,인천광역시 부평구 부평3동,16489,6925,8249,8240
2823754000,28237540,2306054,인천광역시 부평구 부평4동,26231,11261,13285,12946
2823755000,28237550,2306055,인천광역시 부평구 부평5동,24086,9866,12062,12024
2823756000,28237560,2306056,인천광역시 부평구 부평6동,14095,6303,7090,7005
2823757000,28237570,2306057,인천광역시 부평구 산곡1동,22157,8751,11205,10952
2823758000,28237580,2306058,인천광역시 부평구 산곡2동,34160,10665,17008,17152
2823758100,28237581,2306059,인천광역시 부평구 산곡3동,27646,9493,13602,14044
2823758200,28237582,2306060,인천광역시 부평구 산곡4동,21211,6960,10371,10840
2823759100,28237591,2306061,인천광역시 부평구 청천1동,18232,7719,9774,8458
2823759200,28237592,2306062,인천광역시 부평구 청천2동,39932,14089,20189,19743
2823764100,28237641,2306063,인천광역시 부평구 갈산1동,19726,7219,10024,9702
2823764200,28237642,2306064,인천광역시 부평구 갈산2동,24888,8871,12337,12551
2823764600,28237646,2306065,인천광역시 부평구 삼산1동,38267,13291,19028,19239
2823764800,28237648,2306072,인천광역시 부평구 삼산2동,31216,9907,15374,15842
2823765000,28237650,2306066,인천광역시 부평구 부개1동,21328,8231,10912,10416
2823766000,28237660,2306067,인천광역시 부평구 부개2동,22440,8114,11257,11183
2823766100,28237661,2306068,인천광역시 부평구 부개3동,39243,13152,19381,19862
2823767000,28237670,2306069,인천광역시 부평구 일신동,14971,5198,7610,7361
2823768000,28237680,2306070,인천광역시 부평구 십정1동,23303,9247,11937,11366
2823769000,28237690,2306071,인천광역시 부평구 십정2동,30489,12988,15575,14914
2824500000,28245000,#N/A,인천광역시 계양구 ,341268,124321,171410,169858
2824560100,28245601,2307051,인천광역시 계양구 효성1동,35713,12549,18076,17637
2824560200,28245602,2307052,인천광역시 계양구 효성2동,36583,12363,18536,18047
2824561100,28245611,2307053,인천광역시 계양구 계산1동,25720,10629,13067,12653
2824561200,28245612,2307054,인천광역시 계양구 계산2동,20558,8299,10367,10191
2824561300,28245613,2307055,인천광역시 계양구 계산3동,25516,9084,12582,12934
2824561400,28245614,2307062,인천광역시 계양구 계산4동,24021,8093,12005,12016
2824562100,28245621,2307056,인천광역시 계양구 작전1동,34658,11695,17230,17428
2824562200,28245622,2307057,인천광역시 계양구 작전2동,31548,12330,15957,15591
2824564000,28245640,2307058,인천광역시 계양구 작전서운동,34927,12197,17539,17388
2824571000,28245710,2307060,인천광역시 계양구 계양1동,28786,10307,14476,14310
2824572000,28245720,2307061,인천광역시 계양구 계양2동,43238,16775,21575,21663
2826000000,28260000,#N/A,인천광역시 서구 ,395588,142910,200928,194660
2826051500,28260515,2308051,인천광역시 서구 검암경서동,24279,8155,12346,11933
2826053000,28260530,2308053,인천광역시 서구 연희동,48265,17887,24800,23465
2826054200,28260542,2308054,인천광역시 서구 가정1동,18556,7776,9529,9027
2826054300,28260543,2308055,인천광역시 서구 가정2동,16747,6075,8473,8274
2826054400,28260544,2308056,인천광역시 서구 가정3동,13209,4665,6611,6598
2826055000,28260550,2308058,인천광역시 서구 석남1동,25486,9795,13151,12335
2826056000,28260560,2308059,인천광역시 서구 석남2동,17988,7041,9356,8632
2826056100,28260561,2308060,인천광역시 서구 석남3동,18845,6862,9414,9431
2826057500,28260575,2308057,인천광역시 서구 신현원창동,19367,7133,9939,9428
2826058000,28260580,2308062,인천광역시 서구 가좌1동,14949,6027,7888,7061
2826059000,28260590,2308063,인천광역시 서구 가좌2동,24083,7854,11821,12262
2826060000,28260600,2308064,인천광역시 서구 가좌3동,22117,8019,11280,10837
2826061000,28260610,2308065,인천광역시 서구 가좌4동,13214,5332,6657,6557
2826063000,28260630,2308068,인천광역시 서구 검단1동,39682,14327,20259,19423
2826064000,28260640,2308069,인천광역시 서구 검단2동,23227,7969,11732,11495
2826065000,28260650,2308070,인천광역시 서구 검단3동,20661,7063,10349,10312
2826066000,28260660,2308071,인천광역시 서구 검단4동,34913,10930,17323,17590
2871000000,28710000,#N/A,인천광역시 강화군 ,67425,28127,33642,33783
2871025000,28710250,2331011,인천광역시 강화군 강화읍,22949,8994,11366,11583
2871031000,28710310,2331031,인천광역시 강화군 선원면,7338,2864,3650,3688
2871032000,28710320,2331032,인천광역시 강화군 불은면,4221,1808,2123,2098
2871033000,28710330,2331033,인천광역시 강화군 길상면,6233,2608,3141,3092
2871034000,28710340,2331034,인천광역시 강화군 화도면,4322,1883,2165,2157
2871035000,28710350,2331035,인천광역시 강화군 양도면,3653,1585,1881,1772
2871036000,28710360,2331036,인천광역시 강화군 내가면,3154,1440,1532,1622
2871037000,28710370,2331037,인천광역시 강화군 하점면,4094,1837,2063,2031
2871038000,28710380,2331038,인천광역시 강화군 양사면,1981,890,1007,974
2871039000,28710390,2331039,인천광역시 강화군 송해면,3306,1371,1635,1671
2871040000,28710400,2331040,인천광역시 강화군 교동면,3203,1402,1579,1624
2871041000,28710410,2331041,인천광역시 강화군 삼산면,2292,1081,1160,1132
2871042000,28710420,2331042,인천광역시 강화군 서도면,679,364,340,339
2872000000,28720000,#N/A,인천광역시 옹진군 ,17401,8208,9283,8118
2872031000,28720310,2332031,인천광역시 옹진군 북도면,2076,957,1076,1000
2872033000,28720330,2332033,인천광역시 옹진군 백령면,4857,2251,2596,2261
2872034000,28720340,2332034,인천광역시 옹진군 대청면,1513,714,831,682
2872035000,28720350,2332035,인천광역시 옹진군 덕적면,1821,940,937,884
2872036000,28720360,2332037,인천광역시 옹진군 영흥면,4352,1954,2320,2032
2872037000,28720370,2332036,인천광역시 옹진군 자월면,1093,535,564,529
2872038000,28720380,2332032,인천광역시 옹진군 연평면,1689,857,959,730
2900000000,29000000,#N/A,,1421879,511325,705367,716512
2911000000,29110000,#N/A,광주광역시 동구 ,107207,46194,53642,53565
2911052500,29110525,2401051,광주광역시 동구 충장동,5362,2912,2832,2530
2911054500,29110545,2401054,광주광역시 동구 동명동,6006,2889,2999,3007
2911056000,29110560,2401056,광주광역시 동구 계림1동,8543,4432,4316,4227
2911057000,29110570,2401058,광주광역시 동구 계림2동,9711,3692,4743,4968
2911059000,29110590,2401059,광주광역시 동구 산수1동,9967,4476,4979,4988
2911060000,29110600,2401061,광주광역시 동구 산수2동,11434,4429,5631,5803
2911062000,29110620,2401062,광주광역시 동구 지산1동,4748,2214,2376,2372
2911063000,29110630,2401063,광주광역시 동구 지산2동,6539,2752,3339,3200
2911065500,29110655,2401064,광주광역시 동구 서남동,4901,2662,2431,2470
2911068500,29110685,2401068,광주광역시 동구 학동,7983,3839,4019,3964
2911071000,29110710,2401071,광주광역시 동구 학운동,14120,5022,6936,7184
2911073000,29110730,2401072,광주광역시 동구 지원1동,9202,3394,4635,4567
2911074000,29110740,2401073,광주광역시 동구 지원2동,8691,3481,4406,4285
2914000000,29140000,#N/A,광주광역시 서구 ,306321,107761,151024,155297
2914057500,29140575,2402051,광주광역시 서구 양동,6089,2550,3065,3024
2914059000,29140590,2402053,광주광역시 서구 양3동,4232,1616,2133,2099
2914065000,29140650,2402054,광주광역시 서구 농성1동,9470,4014,4721,4749
2914066000,29140660,2402055,광주광역시 서구 농성2동,6124,2607,3124,3000
2914073000,29140730,2402056,광주광역시 서구 광천동,9397,4009,4846,4551
2914074000,29140740,2402057,광주광역시 서구 유덕동,12874,4372,6472,6402
2914074500,29140745,2402066,광주광역시 서구 치평동,31142,9905,15273,15869
2914075100,29140751,2402058,광주광역시 서구 상무1동,25148,9558,12474,12674
2914075200,29140752,2402059,광주광역시 서구 상무2동,26635,10460,13049,13586
2914076000,29140760,2402060,광주광역시 서구 화정1동,17256,6650,8350,8906
2914077000,29140770,2402061,광주광역시 서구 화정2동,18877,6769,9311,9566
2914078000,29140780,2402062,광주광역시 서구 화정3동,13715,4722,6890,6825
2914079000,29140790,2402063,광주광역시 서구 화정4동,22585,7264,11102,11483
2914080000,29140800,2402064,광주광역시 서구 서창동,6272,2569,3253,3019
2914082100,29140821,2402068,광주광역시 서구 금호1동,24993,8179,12061,12932
2914082400,29140824,2402069,광주광역시 서구 금호2동,30166,9022,14756,15410
2914083000,29140830,2402067,광주광역시 서구 풍암동,41346,13495,20144,21202
2915500000,29155000,#N/A,광주광역시 남구 ,213654,77362,104192,109462
2915551000,29155510,2403051,광주광역시 남구 양림동,8126,3269,3958,4168
2915552000,29155520,2403052,광주광역시 남구 방림1동,6011,2278,2890,3121
2915553000,29155530,2403053,광주광역시 남구 방림2동,13004,4724,6335,6669
2915553700,29155537,2403068,광주광역시 남구 봉선1동,18098,6839,8751,9347
2915553800,29155538,2403069,광주광역시 남구 봉선2동,27778,8123,13123,14655
2915554500,29155545,2403054,광주광역시 남구 사직동,6890,3221,3492,3398
2915560500,29155605,2403057,광주광역시 남구 월산동,12135,5322,6188,5947
2915563000,29155630,2403060,광주광역시 남구 월산4동,11703,4746,5898,5805
2915564000,29155640,2403061,광주광역시 남구 월산5동,8830,3453,4386,4444
2915567000,29155670,2403062,광주광역시 남구 백운1동,8940,3252,4381,4559
2915568000,29155680,2403063,광주광역시 남구 백운2동,6751,2794,3402,3349
2915569000,29155690,2403064,광주광역시 남구 주월1동,20409,7154,10127,10282
2915570000,29155700,2403065,광주광역시 남구 주월2동,11438,4238,5690,5748
2915571000,29155710,2403066,광주광역시 남구 효덕동,41072,13270,19478,21594
2915572000,29155720,2403067,광주광역시 남구 송암동,6562,2125,3171,3391
2915573000,29155730,2403070,광주광역시 남구 대촌동,5907,2554,2922,2985
2917000000,29170000,#N/A,광주광역시 북구 ,474389,170983,235508,238881
2917051000,29170510,2404051,광주광역시 북구 중흥1동,5027,2370,2684,2343
2917052000,29170520,2404052,광주광역시 북구 중흥2동,10217,4128,5199,5018
2917053000,29170530,2404053,광주광역시 북구 중흥3동,7007,3007,3539,3468
2917055500,29170555,2404054,광주광역시 북구 중앙동,4700,2205,2440,2260
2917057000,29170570,2404055,광주광역시 북구 임동,11396,4443,5813,5583
2917058000,29170580,2404056,광주광역시 북구 신안동,13472,5809,6956,6516
2917059000,29170590,2404057,광주광역시 북구 용봉동,41373,14397,20782,20591
2917060100,29170601,2404058,광주광역시 북구 운암1동,21125,7029,10388,10737
2917060200,29170602,2404059,광주광역시 북구 운암2동,17036,6522,8619,8417
2917060300,29170603,2404060,광주광역시 북구 운암3동,19317,6456,9418,9899
2917061500,29170615,2404061,광주광역시 북구 동림동,33146,11062,16307,16839
2917062000,29170620,2404062,광주광역시 북구 우산동,17180,7175,8430,8750
2917063500,29170635,2404063,광주광역시 북구 풍향동,8401,3623,4268,4133
2917065000,29170650,2404064,광주광역시 북구 문화동,17165,6586,8326,8839
2917065600,29170656,2404065,광주광역시 북구 문흥1동,20950,6629,10319,10631
2917065700,29170657,2404066,광주광역시 북구 문흥2동,20585,7056,9907,10678
2917066100,29170661,2404067,광주광역시 북구 두암1동,10044,3881,4970,5074
2917066200,29170662,2404068,광주광역시 북구 두암2동,21500,7788,10629,10871
2917066300,29170663,2404069,광주광역시 북구 두암3동,21076,8416,9911,11165
2917066600,29170666,2404070,광주광역시 북구 삼각동,13807,4704,7074,6733
2917066900,29170669,2404078,광주광역시 북구 일곡동,35044,10804,17103,17941
2917067300,29170673,2404071,광주광역시 북구 매곡동,16220,4990,8142,8078
2917067600,29170676,2404072,광주광역시 북구 오치1동,13023,5044,6672,6351
2917067700,29170677,2404073,광주광역시 북구 오치2동,16396,6436,7904,8492
2917068500,29170685,2404074,광주광역시 북구 석곡동,3123,1244,1616,1507
2917069500,29170695,2404077,광주광역시 북구 건국동,56059,19179,28092,27967
2920000000,29200000,#N/A,광주광역시 광산구 ,320308,109025,161001,159307
2920051500,29200515,2405051,광주광역시 광산구 송정1동,12802,4512,6537,6265
2920052500,29200525,2405052,광주광역시 광산구 송정2동,7371,2923,3701,3670
2920054000,29200540,2405054,광주광역시 광산구 도산동,16861,6007,8557,8304
2920055000,29200550,2405055,광주광역시 광산구 신흥동,5641,2080,2906,2735
2920056500,29200565,2405056,광주광역시 광산구 어룡동,22055,7509,11185,10870
2920058000,29200580,2405058,광주광역시 광산구 우산동,27643,10650,13697,13946
2920060000,29200600,2405059,광주광역시 광산구 월곡1동,16580,5780,8396,8184
2920061000,29200610,2405060,광주광역시 광산구 월곡2동,22689,7583,11528,11161
2920062000,29200620,2405061,광주광역시 광산구 비아동,8173,3146,4216,3957
2920062400,29200624,2405069,광주광역시 광산구 첨단1동,25805,7053,12800,13005
2920062600,29200626,2405070,광주광역시 광산구 첨단2동,43204,13803,21350,21854
2920063000,29200630,2405062,광주광역시 광산구 신가동,57021,18363,28405,28616
2920063500,29200635,2405071,광주광역시 광산구 운남동,36583,11355,18284,18299
2920064000,29200640,2405063,광주광역시 광산구 하남동,2563,1311,1522,1041
2920065000,29200650,2405064,광주광역시 광산구 임곡동,2795,1269,1471,1324
2920066000,29200660,2405065,광주광역시 광산구 동곡동,2585,1099,1331,1254
2920067000,29200670,2405066,광주광역시 광산구 평동,4255,1952,2240,2015
2920068000,29200680,2405067,광주광역시 광산구 삼도동,3018,1351,1515,1503
2920069000,29200690,2405068,광주광역시 광산구 본량동,2664,1279,1360,1304
3000000000,30000000,#N/A,대전광역시  ,1480444,530811,741362,739082
3011000000,30110000,#N/A,대전광역시 동구 ,244508,93647,124032,120476
3011051500,30110515,2501076,대전광역시 동구 중앙동,10065,5089,5357,4708
3011053000,30110530,2501053,대전광역시 동구 효동,21400,7404,10772,10628
3011054500,30110545,2501077,대전광역시 동구 신인동,15078,5601,7634,7444
3011055100,30110551,2501055,대전광역시 동구 판암1동,12124,4575,6115,6009
3011055200,30110552,2501056,대전광역시 동구 판암2동,13083,5668,6440,6643
3011056000,30110560,2501057,대전광역시 동구 용운동,21437,7750,10753,10684
3011058500,30110585,2501078,대전광역시 동구 대동,9396,3876,4777,4619
3011059000,30110590,2501060,대전광역시 동구 자양동,12329,4792,6258,6071
3011062000,30110620,2501063,대전광역시 동구 가양1동,14945,5943,7683,7262
3011063000,30110630,2501064,대전광역시 동구 가양2동,23916,8534,12006,11910
3011064000,30110640,2501065,대전광역시 동구 용전동,21437,8350,10872,10565
3011066500,30110665,2501079,대전광역시 동구 성남동,12517,4921,6344,6173
3011067000,30110670,2501068,대전광역시 동구 홍도동,14139,5372,7190,6949
3011069500,30110695,2501080,대전광역시 동구 삼성동,20171,7758,10382,9789
3011072500,30110725,2501073,대전광역시 동구 대청동,3269,1355,1699,1570
3011074000,30110740,2501075,대전광역시 동구 산내동,19202,6659,9750,9452
3014000000,30140000,#N/A,대전광역시 중구 ,264876,97585,132213,132663
3014053500,30140535,2502051,대전광역시 중구 은행선화동,15501,7775,7746,7755
3014055000,30140550,2502053,대전광역시 중구 목동,12282,4009,5945,6337
3014056000,30140560,2502054,대전광역시 중구 중촌동,17676,6472,8666,9010
3014057500,30140575,2502055,대전광역시 중구 대흥동,11261,4841,5708,5553
3014060500,30140605,2502056,대전광역시 중구 문창동,6052,2625,3090,2962
3014062000,30140620,2502057,대전광역시 중구 석교동,20656,7524,10512,10144
3014063000,30140630,2502058,대전광역시 중구 대사동,7237,3101,3681,3556
3014064000,30140640,2502059,대전광역시 중구 부사동,8120,3206,4114,4006
3014065500,30140655,2502060,대전광역시 중구 용두동,11689,4617,5828,5861
3014067000,30140670,2502062,대전광역시 중구 오류동,10883,3956,5285,5598
3014068000,30140680,2502063,대전광역시 중구 태평1동,14694,4885,7301,7393
3014069000,30140690,2502064,대전광역시 중구 태평2동,31863,9962,15547,16316
3014070000,30140700,2502065,대전광역시 중구 유천1동,7997,3517,3980,4017
3014071000,30140710,2502066,대전광역시 중구 유천2동,16352,5816,8196,8156
3014072000,30140720,2502067,대전광역시 중구 문화1동,24528,8092,12171,12357
3014073000,30140730,2502068,대전광역시 중구 문화2동,16843,5999,8387,8456
3014074000,30140740,2502069,대전광역시 중구 산성동,31242,11188,16056,15186
3017000000,30170000,#N/A,대전광역시 서구 ,499576,174102,246567,253009
3017051000,30170510,2503051,대전광역시 서구 복수동,20987,6545,10388,10599
3017052000,30170520,2503052,대전광역시 서구 도마1동,22118,8436,11152,10966
3017053000,30170530,2503053,대전광역시 서구 도마2동,24376,9038,12342,12034
3017053500,30170535,2503054,대전광역시 서구 정림동,20248,6333,10151,10097
3017054000,30170540,2503055,대전광역시 서구 변동,19143,7093,9729,9414
3017055000,30170550,2503056,대전광역시 서구 용문동,14994,5967,7410,7584
3017055500,30170555,2503057,대전광역시 서구 탄방동,29655,11761,14281,15374
3017056000,30170560,2503061,대전광역시 서구 괴정동,18118,7548,8867,9251
3017057000,30170570,2503062,대전광역시 서구 가장동,13834,4640,6836,6998
3017057500,30170575,2503063,대전광역시 서구 내동,27610,8832,13556,14054
3017058100,30170581,2503064,대전광역시 서구 갈마1동,25053,9560,12293,12760
3017058200,30170582,2503065,대전광역시 서구 갈마2동,29934,12108,14440,15494
3017058600,30170586,2503066,대전광역시 서구 월평1동,13399,6076,6692,6707
3017058700,30170587,2503067,대전광역시 서구 월평2동,20037,7361,9573,10464
3017058800,30170588,2503068,대전광역시 서구 월평3동,26904,7731,13478,13426
3017059000,30170590,2503070,대전광역시 서구 가수원동,15113,5209,7568,7545
3017059600,30170596,2503072,대전광역시 서구 관저1동,17287,5439,8461,8826
3017059700,30170597,2503073,대전광역시 서구 관저2동,33900,10399,16418,17482
3017060000,30170600,2503071,대전광역시 서구 기성동,4520,1665,2348,2172
3017061000,30170610,2503058,대전광역시 서구 삼천동,24261,7792,11899,12362
3017063000,30170630,2503059,대전광역시 서구 둔산1동,18567,5574,9269,9298
3017064000,30170640,2503060,대전광역시 서구 둔산2동,43138,13357,21250,21888
3017065000,30170650,2503069,대전광역시 서구 만년동,16380,5638,8166,8214
3020000000,30200000,#N/A,대전광역시 유성구 ,259594,91103,131021,128573
3020052000,30200520,2504051,대전광역시 유성구 진잠동,29665,10856,14880,14785
3020053000,30200530,2504053,대전광역시 유성구 온천1동,22092,9879,11360,10732
3020054000,30200540,2504054,대전광역시 유성구 온천2동,34815,13934,17827,16988
3020054600,30200546,2504059,대전광역시 유성구 노은1동,22781,7668,11210,11571
3020054700,30200547,2504060,대전광역시 유성구 노은2동,42883,13604,21278,21605
3020055000,30200550,2504055,대전광역시 유성구 신성동,26283,9369,13633,12650
3020057000,30200570,2504057,대전광역시 유성구 전민동,26545,8490,13325,13220
3020058000,30200580,2504058,대전광역시 유성구 구즉동,54530,17303,27508,27022
3023000000,30230000,#N/A,대전광역시 대덕구 ,211890,74374,107529,104361
3023051000,30230510,2505051,대전광역시 대덕구 오정동,20609,8218,10810,9799
3023052000,30230520,2505052,대전광역시 대덕구 대화동,10808,3979,5614,5194
3023052500,30230525,2505053,대전광역시 대덕구 회덕동,19509,6888,9926,9583
3023053300,30230533,2505054,대전광역시 대덕구 비래동,20302,6834,10230,10072
3023054300,30230543,2505062,대전광역시 대덕구 송촌동,33020,10143,16526,16494
3023054600,30230546,2505055,대전광역시 대덕구 중리동,24618,9706,12542,12076
3023055000,30230550,2505058,대전광역시 대덕구 신탄진동,14271,5079,7312,6959
3023056000,30230560,2505059,대전광역시 대덕구 석봉동,7335,2534,3777,3558
3023057000,30230570,2505060,대전광역시 대덕구 덕암동,16535,5776,8645,7890
3023058000,30230580,2505061,대전광역시 대덕구 목상동,7091,2540,3736,3355
3023060000,30230600,2505056,대전광역시 대덕구 법1동,15846,5637,7621,8225
3023061000,30230610,2505057,대전광역시 대덕구 법2동,21946,7040,10790,11156
3100000000,31000000,#N/A,울산광역시  ,1110740,388876,571999,538741
3111000000,31110000,#N/A,울산광역시 중구 ,234073,83791,119834,114239
3111051000,31110510,2601051,울산광역시 중구 학성동,13100,5459,6799,6301
3111052000,31110520,2601052,울산광역시 중구 반구1동,18075,6836,9419,8656
3111053000,31110530,2601053,울산광역시 중구 반구2동,11165,4098,5670,5495
3111054000,31110540,2601054,울산광역시 중구 복산1동,11482,4261,5898,5584
3111055000,31110550,2601055,울산광역시 중구 복산2동,10829,3648,5501,5328
3111056000,31110560,2601056,울산광역시 중구 북정동,20647,6987,10425,10222
3111057000,31110570,2601057,울산광역시 중구 옥교동,7922,3445,4058,3864
3111058000,31110580,2601058,울산광역시 중구 성남동,7249,3321,3732,3517
3111059000,31110590,2601059,울산광역시 중구 우정동,21170,7993,10798,10372
3111060000,31110600,2601060,울산광역시 중구 태화동,23068,7613,11571,11497
3111061000,31110610,2601061,울산광역시 중구 다운동,32579,11356,16707,15872
3111062000,31110620,2601062,울산광역시 중구 병영1동,28347,9502,14528,13819
3111063000,31110630,2601063,울산광역시 중구 병영2동,19321,6525,10025,9296
3111064000,31110640,2601064,울산광역시 중구 약사동,9119,2747,4703,4416
3114000000,31140000,#N/A,울산광역시 남구 ,343032,120903,175099,167933
3114051000,31140510,2602051,울산광역시 남구 신정1동,19746,7972,9895,9851
3114052000,31140520,2602052,울산광역시 남구 신정2동,22208,7461,11217,10991
3114053000,31140530,2602053,울산광역시 남구 신정3동,11591,5027,5864,5727
3114054000,31140540,2602054,울산광역시 남구 신정4동,26452,8632,13409,13043
3114055000,31140550,2602055,울산광역시 남구 신정5동,8311,3461,4368,3943
3114056000,31140560,2602056,울산광역시 남구 달동,30793,11599,15379,15414
3114057000,31140570,2602057,울산광역시 남구 삼산동,47434,17234,24015,23419
3114058500,31140585,2602058,울산광역시 남구 삼호동,25828,9154,13082,12746
3114059500,31140595,2602059,울산광역시 남구 무거동,38657,13121,20024,18633
3114060000,31140600,2602060,울산광역시 남구 옥동,29242,8709,14931,14311
3114062500,31140625,2602062,울산광역시 남구 대현동,32585,10702,16701,15884
3114063500,31140635,2602063,울산광역시 남구 수암동,16508,5105,8378,8130
3114064000,31140640,2602064,울산광역시 남구 선암동,17684,5842,9150,8534
3114067000,31140670,2602061,울산광역시 남구 야음장생포동,15993,6884,8686,7307
3117000000,31170000,#N/A,울산광역시 동구 ,176647,60580,92992,83655
3117051000,31170510,2603051,울산광역시 동구 방어동,38395,13438,20166,18229
3117052000,31170520,2603052,울산광역시 동구 일산동,9120,3785,4834,4286
3117053000,31170530,2603053,울산광역시 동구 화정동,20786,7527,10757,10029
3117054000,31170540,2603054,울산광역시 동구 대송동,16922,5537,8842,8080
3117055000,31170550,2603055,울산광역시 동구 전하1동,18789,6641,10307,8482
3117056000,31170560,2603056,울산광역시 동구 전하2동,5795,2120,3080,2715
3117057000,31170570,2603057,울산광역시 동구 전하3동,8783,3104,4678,4105
3117058000,31170580,2603058,울산광역시 동구 남목1동,12477,4136,6578,5899
3117059000,31170590,2603059,울산광역시 동구 남목2동,29399,9270,15348,14051
3117060000,31170600,2603060,울산광역시 동구 남목3동,16181,5022,8402,7779
3120000000,31200000,#N/A,울산광역시 북구 ,165836,54114,86090,79746
3120051000,31200510,2604051,울산광역시 북구 농소1동,22037,7625,11299,10738
3120052000,31200520,2604052,울산광역시 북구 농소2동,29510,9142,15222,14288
3120053000,31200530,2604053,울산광역시 북구 농소3동,38218,11526,19519,18699
3120054000,31200540,2604054,울산광역시 북구 강동동,4779,2037,2487,2292
3120056000,31200560,2604056,울산광역시 북구 효문동,29908,9487,15430,14478
3120057000,31200570,2604057,울산광역시 북구 송정동,14583,4325,7514,7069
3120058000,31200580,2604058,울산광역시 북구 양정동,12768,4939,7138,5630
3120059000,31200590,2604059,울산광역시 북구 염포동,14033,5033,7481,6552
3171000000,31710000,#N/A,울산광역시 울주군 ,191152,69488,97984,93168
3171025000,31710250,2631011,울산광역시 울주군 온산읍,22774,8673,12213,10561
3171025300,31710253,2631012,울산광역시 울주군 언양읍,24089,8957,12248,11841
3171025600,31710256,2631013,울산광역시 울주군 온양읍,22214,7733,11333,10881
3171025900,31710259,2631014,울산광역시 울주군 범서읍,56965,17725,28832,28133
3171031000,31710310,2631031,울산광역시 울주군 서생면,7252,3089,3774,3478
3171033000,31710330,2631033,울산광역시 울주군 청량면,14973,5594,7733,7240
3171034000,31710340,2631034,울산광역시 울주군 웅촌면,9014,3774,4718,4296
3171036000,31710360,2631036,울산광역시 울주군 두동면,3858,1719,1992,1866
3171037000,31710370,2631037,울산광역시 울주군 두서면,3589,1679,1781,1808
3171038000,31710380,2631038,울산광역시 울주군 상북면,9028,3627,4546,4482
3171039000,31710390,2631039,울산광역시 울주군 삼남면,15460,6031,7830,7630
3171040000,31710400,2631040,울산광역시 울주군 삼동면,1936,887,984,952
4100000000,41000000,#N/A,경기도  ,11261364,4272292,5675463,5585901
4111000000,41110000,#N/A,경기도 수원시 ,1068064,402718,536444,531620
4111100000,41111000,#N/A,경기도 수원시 장안구 ,285486,104954,142847,142639
4111156000,41111560,3101154,경기도 수원시 장안구 파장동,21668,8491,10959,10709
4111156600,41111566,3101155,경기도 수원시 장안구 율천동,34521,13362,17805,16716
4111157100,41111571,3101156,경기도 수원시 장안구 정자1동,25685,9230,12680,13005
4111157200,41111572,3101157,경기도 수원시 장안구 정자2동,34871,12333,17268,17603
4111157300,41111573,3101162,경기도 수원시 장안구 정자3동,48222,14971,24031,24191
4111158000,41111580,3101158,경기도 수원시 장안구 영화동,22687,9930,11201,11486
4111159100,41111591,3101159,경기도 수원시 장안구 송죽동,20565,7897,10302,10263
4111159700,41111597,3101160,경기도 수원시 장안구 조원1동,33808,12740,16948,16860
4111159800,41111598,3101163,경기도 수원시 장안구 조원2동,19322,5949,9504,9818
4111160000,41111600,3101161,경기도 수원시 장안구 연무동,24137,10051,12149,11988
4111300000,41113000,#N/A,경기도 수원시 권선구 ,308447,114985,155538,152909
4111352000,41113520,3101252,경기도 수원시 권선구 세류1동,11192,4960,5574,5618
4111353000,41113530,3101253,경기도 수원시 권선구 세류2동,27171,11185,13863,13308
4111354000,41113540,3101254,경기도 수원시 권선구 세류3동,26107,10678,13125,12982
4111355000,41113550,3101255,경기도 수원시 권선구 평동,39355,14141,19821,19534
4111356000,41113560,3101256,경기도 수원시 권선구 서둔동,42452,15889,21355,21097
4111365000,41113650,3101257,경기도 수원시 권선구 구운동,29178,10242,14739,14439
4111366000,41113660,3101263,경기도 수원시 권선구 금호동,37319,11588,18546,18773
4111367000,41113670,3101260,경기도 수원시 권선구 권선1동,23776,9679,12025,11751
4111368000,41113680,3101264,경기도 수원시 권선구 권선2동,29877,9263,14886,14991
4111369000,41113690,3101261,경기도 수원시 권선구 곡선동,29996,13514,15611,14385
4111370000,41113700,3101262,경기도 수원시 권선구 입북동,12024,3846,5993,6031
4111500000,41115000,#N/A,경기도 수원시 팔달구 ,213961,88825,106567,107394
4111565000,41115650,3101367,경기도 수원시 팔달구 매교동,11543,5372,5828,5715
4111566000,41115660,3101368,경기도 수원시 팔달구 매산동,12607,5887,6153,6454
4111567000,41115670,3101369,경기도 수원시 팔달구 고등동,24616,10482,12174,12442
4111568000,41115680,3101370,경기도 수원시 팔달구 화서1동,22890,8941,11144,11746
4111569000,41115690,3101371,경기도 수원시 팔달구 화서2동,27825,9124,13728,14097
4111570000,41115700,3101353,경기도 수원시 팔달구 지동,17478,7625,8708,8770
4111571000,41115710,3101354,경기도 수원시 팔달구 우만1동,25919,10915,12895,13024
4111572000,41115720,3101355,경기도 수원시 팔달구 우만2동,20084,7518,10153,9931
4111573000,41115730,3101356,경기도 수원시 팔달구 인계동,36446,15889,18403,18043
4111574000,41115740,3101372,경기도 수원시 팔달구 행궁동,14553,7072,7381,7172
4111700000,41117000,#N/A,경기도 수원시 영통구 ,260170,93954,131492,128678
4111751000,41117510,3101451,경기도 수원시 영통구 매탄1동,22867,8357,11315,11552
4111752000,41117520,3101452,경기도 수원시 영통구 매탄2동,17206,6387,8566,8640
4111753000,41117530,3101453,경기도 수원시 영통구 매탄3동,38481,14441,19708,18773
4111754000,41117540,3101454,경기도 수원시 영통구 매탄4동,27635,10218,13903,13732
4111755000,41117550,3101455,경기도 수원시 영통구 원천동,18690,8313,9722,8968
4111757000,41117570,3101457,경기도 수원시 영통구 영통1동,46125,16849,23402,22723
4111758000,41117580,3101458,경기도 수원시 영통구 영통2동,50816,16732,25607,25209
4111759000,41117590,3101459,경기도 수원시 영통구 태장동,38350,12657,19269,19081
4113000000,41130000,#N/A,경기도 성남시 ,944080,368246,471969,472111
4113100000,41131000,#N/A,경기도 성남시 수정구 ,249228,105619,126675,122553
4113151000,41131510,3102151,경기도 성남시 수정구 신흥1동,17179,8057,8733,8446
4113152000,41131520,3102152,경기도 성남시 수정구 신흥2동,33485,12972,16758,16727
4113153000,41131530,3102153,경기도 성남시 수정구 신흥3동,12869,5984,6514,6355
4113154000,41131540,3102154,경기도 성남시 수정구 태평1동,19546,8995,9872,9674
4113155000,41131550,3102155,경기도 성남시 수정구 태평2동,21648,8867,10989,10659
4113156000,41131560,3102156,경기도 성남시 수정구 태평3동,17811,7303,9091,8720
4113156100,41131561,3102157,경기도 성남시 수정구 태평4동,17888,7148,9042,8846
4113157000,41131570,3102158,경기도 성남시 수정구 수진1동,18124,8368,9229,8895
4113158000,41131580,3102159,경기도 성남시 수정구 수진2동,21375,8617,10808,10567
4113159000,41131590,3102160,경기도 성남시 수정구 단대동,15087,5736,7559,7528
4113160000,41131600,3102161,경기도 성남시 수정구 산성동,17289,7125,8800,8489
4113161000,41131610,3102162,경기도 성남시 수정구 양지동,11689,4493,5807,5882
4113162000,41131620,3102163,경기도 성남시 수정구 복정동,15486,8074,8359,7127
4113163000,41131630,3102164,경기도 성남시 수정구 신촌동,3902,1429,2047,1855
4113164000,41131640,3102165,경기도 성남시 수정구 고등동,2656,1162,1399,1257
4113165000,41131650,3102166,경기도 성남시 수정구 시흥동,3194,1289,1668,1526
4113300000,41133000,#N/A,경기도 성남시 중원구 ,265133,104984,134740,130393
4113351000,41133510,3102251,경기도 성남시 중원구 성남동,32379,13523,16592,15787
4113352000,41133520,3102252,경기도 성남시 중원구 중동,19697,9044,10093,9604
4113353000,41133530,3102253,경기도 성남시 중원구 금광1동,26094,10538,13242,12852
4113354000,41133540,3102254,경기도 성남시 중원구 금광2동,31610,12414,15612,15998
4113355000,41133550,3102255,경기도 성남시 중원구 은행1동,14061,4936,7033,7028
4113356000,41133560,3102256,경기도 성남시 중원구 은행2동,37938,15169,18900,19038
4113357000,41133570,3102257,경기도 성남시 중원구 상대원1동,32449,12483,16989,15460
4113358000,41133580,3102258,경기도 성남시 중원구 상대원2동,19585,8393,10082,9503
4113359000,41133590,3102259,경기도 성남시 중원구 상대원3동,17737,7193,9183,8554
4113366000,41133660,3102260,경기도 성남시 중원구 하대원동,23947,7819,12200,11747
4113367000,41133670,3102261,경기도 성남시 중원구 도촌동,9636,3472,4814,4822
4113500000,41135000,#N/A,경기도 성남시 분당구 ,429719,157643,210554,219165
4113551000,41135510,3102351,경기도 성남시 분당구 분당동,30173,10815,14800,15373
4113552000,41135520,3102353,경기도 성남시 분당구 수내1동,18413,7228,8987,9426
4113553000,41135530,3102354,경기도 성남시 분당구 수내2동,11650,3586,5696,5954
4113554000,41135540,3102352,경기도 성남시 분당구 수내3동,16207,5600,8020,8187
4113555000,41135550,3102357,경기도 성남시 분당구 정자1동,51818,19704,25401,26417
4113556000,41135560,3102355,경기도 성남시 분당구 정자2동,19816,8140,9419,10397
4113557000,41135570,3102356,경기도 성남시 분당구 정자3동,17985,6376,8781,9204
4113558000,41135580,3102358,경기도 성남시 분당구 서현1동,33774,12671,16459,17315
4113559000,41135590,3102359,경기도 성남시 분당구 서현2동,21263,7224,10623,10640
4113560000,41135600,3102360,경기도 성남시 분당구 이매1동,29742,10143,14698,15044
4113561000,41135610,3102361,경기도 성남시 분당구 이매2동,15760,5069,7770,7990
4113562000,41135620,3102362,경기도 성남시 분당구 야탑1동,20107,7654,9923,10184
4113563000,41135630,3102364,경기도 성남시 분당구 야탑2동,19191,6683,9209,9982
4113564000,41135640,3102363,경기도 성남시 분당구 야탑3동,35657,13394,17750,17907
4113565000,41135650,3102373,경기도 성남시 분당구 판교동,266,113,143,123
4113566200,41135662,3102371,경기도 성남시 분당구 금곡동,30235,11450,14482,15753
4113566500,41135665,3102372,경기도 성남시 분당구 구미1동,19989,7344,9852,10137
4113567000,41135670,3102367,경기도 성남시 분당구 구미동,35854,13566,17650,18204
4113568000,41135680,3102368,경기도 성남시 분당구 운중동,1819,883,891,928
4115000000,41150000,#N/A,경기도 의정부시 ,430259,161185,213245,217014
4115051000,41150510,3103051,경기도 의정부시 의정부1동,20104,9265,10089,10015
4115052000,41150520,3103052,경기도 의정부시 의정부2동,28071,11640,13978,14093
4115053000,41150530,3103053,경기도 의정부시 의정부3동,14401,6217,7227,7174
4115054500,41150545,3103055,경기도 의정부시 호원1동,32554,11907,16136,16418
4115055500,41150555,3103065,경기도 의정부시 호원2동,38910,13167,19273,19637
4115056100,41150561,3103056,경기도 의정부시 장암동,19179,7121,9330,9849
4115056700,41150567,3103057,경기도 의정부시 신곡1동,48342,17404,23942,24400
4115056800,41150568,3103058,경기도 의정부시 신곡2동,49308,16122,24076,25232
4115057300,41150573,3103059,경기도 의정부시 송산1동,35897,13183,17915,17982
4115057600,41150576,3103066,경기도 의정부시 송산2동,37298,13184,18391,18907
4115058000,41150580,3103060,경기도 의정부시 자금동,32148,12033,15916,16232
4115059000,41150590,3103061,경기도 의정부시 가능1동,27638,11626,13754,13884
4115060000,41150600,3103062,경기도 의정부시 가능2동,11071,4505,5516,5555
4115061000,41150610,3103063,경기도 의정부시 가능3동,12124,5080,6101,6023
4115062000,41150620,3103064,경기도 의정부시 녹양동,23214,8731,11601,11613
4117000000,41170000,#N/A,경기도 안양시 ,620692,226773,309845,310847
4117100000,41171000,#N/A,경기도 안양시 만안구 ,263154,100734,132497,130657
4117151000,41171510,3104151,경기도 안양시 만안구 안양1동,18904,6543,9435,9469
4117152000,41171520,3104152,경기도 안양시 만안구 안양2동,25486,10462,12817,12669
4117153000,41171530,3104153,경기도 안양시 만안구 안양3동,20033,7890,9957,10076
4117154000,41171540,3104154,경기도 안양시 만안구 안양4동,7475,3076,3711,3764
4117155000,41171550,3104155,경기도 안양시 만안구 안양5동,15690,6439,7826,7864
4117156000,41171560,3104156,경기도 안양시 만안구 안양6동,19223,8216,9802,9421
4117157000,41171570,3104157,경기도 안양시 만안구 안양7동,17146,6586,8804,8342
4117158000,41171580,3104158,경기도 안양시 만안구 안양8동,13465,5550,6820,6645
4117158100,41171581,3104159,경기도 안양시 만안구 안양9동,19793,7228,9917,9876
4117159000,41171590,3104160,경기도 안양시 만안구 석수1동,19366,6906,9568,9798
4117160000,41171600,3104161,경기도 안양시 만안구 석수2동,33405,12351,16968,16437
4117161000,41171610,3104162,경기도 안양시 만안구 석수3동,11192,4325,5721,5471
4117162100,41171621,3104163,경기도 안양시 만안구 박달1동,18031,7523,9192,8839
4117163000,41171630,3104164,경기도 안양시 만안구 박달2동,23945,7639,11959,11986
4117300000,41173000,#N/A,경기도 안양시 동안구 ,357538,126039,177348,180190
4117351000,41173510,3104251,경기도 안양시 동안구 비산1동,28222,9543,13970,14252
4117352000,41173520,3104252,경기도 안양시 동안구 비산2동,10622,3669,5210,5412
4117353000,41173530,3104253,경기도 안양시 동안구 비산3동,27335,9964,13675,13660
4117354000,41173540,3104254,경기도 안양시 동안구 부흥동,20259,6902,9931,10328
4117354600,41173546,3104255,경기도 안양시 동안구 달안동,13856,5948,6582,7274
4117355000,41173550,3104256,경기도 안양시 동안구 관양1동,29019,10801,14472,14547
4117356000,41173560,3104257,경기도 안양시 동안구 관양2동,17640,7369,8910,8730
4117356600,41173566,3104258,경기도 안양시 동안구 부림동,28079,10450,13895,14184
4117357000,41173570,3104259,경기도 안양시 동안구 평촌동,16751,5412,8427,8324
4117357600,41173576,3104260,경기도 안양시 동안구 평안동,28004,9087,13908,14096
4117357800,41173578,3104261,경기도 안양시 동안구 귀인동,18742,5557,9225,9517
4117358000,41173580,3104262,경기도 안양시 동안구 호계1동,18504,7518,9397,9107
4117359000,41173590,3104263,경기도 안양시 동안구 호계2동,29276,10179,14519,14757
4117360000,41173600,3104264,경기도 안양시 동안구 호계3동,25616,8604,12837,12779
4117361000,41173610,3104265,경기도 안양시 동안구 범계동,17736,6068,8582,9154
4117362000,41173620,3104266,경기도 안양시 동안구 신촌동,15324,4778,7646,7678
4117363000,41173630,3104267,경기도 안양시 동안구 갈산동,12553,4190,6162,6391
4119000000,41190000,#N/A,경기도 부천시 ,866173,319658,435010,431163
4119500000,41195000,#N/A,경기도 부천시 원미구 ,440882,162441,220310,220572
4119551000,41195510,3105151,경기도 부천시 원미구 심곡1동,14330,6301,7292,7038
4119552000,41195520,3105152,경기도 부천시 원미구 심곡2동,16574,8376,8362,8212
4119553000,41195530,3105153,경기도 부천시 원미구 심곡3동,15611,6506,7991,7620
4119554000,41195540,3105154,경기도 부천시 원미구 원미1동,20685,7862,10617,10068
4119555000,41195550,3105155,경기도 부천시 원미구 원미2동,16566,6578,8350,8216
4119556000,41195560,3105156,경기도 부천시 원미구 소사동,11092,4914,5546,5546
4119557000,41195570,3105157,경기도 부천시 원미구 역곡1동,19531,6955,9796,9735
4119558000,41195580,3105158,경기도 부천시 원미구 역곡2동,18159,6986,8991,9168
4119559000,41195590,3105159,경기도 부천시 원미구 춘의동,16431,6557,8350,8081
4119560000,41195600,3105160,경기도 부천시 원미구 도당동,26067,9947,13579,12488
4119561000,41195610,3105161,경기도 부천시 원미구 약대동,12588,4769,6561,6027
4119562000,41195620,3105162,경기도 부천시 원미구 중동,17409,7045,8736,8673
4119563000,41195630,3105163,경기도 부천시 원미구 중1동,36011,12826,17603,18408
4119564000,41195640,3105164,경기도 부천시 원미구 중2동,32726,10420,16194,16532
4119565000,41195650,3105165,경기도 부천시 원미구 중3동,25549,8879,12531,13018
4119566000,41195660,3105166,경기도 부천시 원미구 중4동,23939,8679,11698,12241
4119567000,41195670,3105167,경기도 부천시 원미구 상동,22030,8408,10840,11190
4119568000,41195680,3105168,경기도 부천시 원미구 상1동,28516,9947,14116,14400
4119569000,41195690,3105169,경기도 부천시 원미구 상2동,32731,10285,16071,16660
4119570000,41195700,3105170,경기도 부천시 원미구 상3동,34337,10201,17086,17251
4119700000,41197000,#N/A,경기도 부천시 소사구 ,229632,84771,115356,114276
4119751000,41197510,3105251,경기도 부천시 소사구 심곡본1동,20558,8492,10319,10239
4119752000,41197520,3105252,경기도 부천시 원미구 심곡2동,20575,8613,10198,10377
4119753000,41197530,3105253,경기도 부천시 소사구 소사본1동,16262,6389,8289,7973
4119754000,41197540,3105254,경기도 부천시 소사구 소사본2동,10991,4556,5547,5444
4119755000,41197550,3105255,경기도 부천시 소사구 소사본3동,37107,12449,18611,18496
4119756000,41197560,3105256,경기도 부천시 소사구 범박동,22094,7035,11086,11008
4119757000,41197570,3105257,경기도 부천시 소사구 괴안동,24646,8579,12258,12388
4119758000,41197580,3105258,경기도 부천시 소사구 역곡3동,25811,10116,13030,12781
4119759000,41197590,3105259,경기도 부천시 소사구 송내1동,24031,8519,12056,11975
4119760000,41197600,3105260,경기도 부천시 소사구 송내2동,27557,10023,13962,13595
4119900000,41199000,#N/A,경기도 부천시 오정구 ,195659,72446,99344,96315
4119951000,41199510,3105351,경기도 부천시 오정구 성곡동,44301,15976,22313,21988
4119952000,41199520,3105352,경기도 부천시 오정구 원종1동,27338,9839,13777,13561
4119953000,41199530,3105353,경기도 부천시 오정구 원종2동,25429,9270,12748,12681
4119954000,41199540,3105354,경기도 부천시 오정구 고강본동,35581,13526,17840,17741
4119955000,41199550,3105355,경기도 부천시 오정구 고강1동,17880,6683,8990,8890
4119956000,41199560,3105356,경기도 부천시 오정구 오정동,23343,8261,12073,11270
4119957000,41199570,3105357,경기도 부천시 오정구 신흥동,21787,8891,11603,10184
4121000000,41210000,#N/A,경기도 광명시 ,310915,115540,154971,155944
4121051000,41210510,3106051,경기도 광명시 광명1동,17051,6532,8613,8438
4121052000,41210520,3106052,경기도 광명시 광명2동,13612,5406,6753,6859
4121054000,41210540,3106053,경기도 광명시 광명3동,13173,5405,6467,6706
4121055000,41210550,3106054,경기도 광명시 광명4동,17558,6529,8705,8853
4121056000,41210560,3106055,경기도 광명시 광명5동,17615,6644,8829,8786
4121057000,41210570,3106056,경기도 광명시 광명6동,12578,4620,6349,6229
4121058000,41210580,3106057,경기도 광명시 광명7동,28297,10045,14300,13997
4121059000,41210590,3106058,경기도 광명시 철산1동,15004,4985,7403,7601
4121060000,41210600,3106059,경기도 광명시 철산2동,19982,8026,10080,9902
4121061000,41210610,3106060,경기도 광명시 철산3동,28639,9595,14221,14418
4121062000,41210620,3106061,경기도 광명시 철산4동,17011,6537,8524,8487
4121063100,41210631,3106062,경기도 광명시 하안1동,16285,6561,7986,8299
4121063200,41210632,3106063,경기도 광명시 하안2동,18098,7037,8895,9203
4121063300,41210633,3106064,경기도 광명시 하안3동,25858,9550,12423,13435
4121063400,41210634,3106065,경기도 광명시 하안4동,15849,5490,7827,8022
4121064000,41210640,3106066,경기도 광명시 소하1동,9836,3763,4989,4847
4121065000,41210650,3106067,경기도 광명시 소하2동,21835,7729,11158,10677
4121066000,41210660,3106068,경기도 광명시 학온동,2634,1086,1449,1185
4122000000,41220000,#N/A,경기도 평택시 ,406874,157113,206723,200151
4122025000,41220250,3107011,경기도 평택시 팽성읍,29789,12813,15134,14655
4122025300,41220253,3107012,경기도 평택시 안중읍,39714,13936,19980,19734
4122025600,41220256,3107013,경기도 평택시 포승읍,26401,11527,14443,11958
4122031000,41220310,3107031,경기도 평택시 진위면,13873,5772,7171,6702
4122032000,41220320,3107032,경기도 평택시 서탄면,4247,1775,2264,1983
4122033000,41220330,3107033,경기도 평택시 고덕면,16112,6046,8376,7736
4122034000,41220340,3107034,경기도 평택시 오성면,6465,2608,3343,3122
4122035000,41220350,3107035,경기도 평택시 청북면,6681,3049,3629,3052
4122037000,41220370,3107037,경기도 평택시 현덕면,6888,2882,3599,3289
4122051000,41220510,3107051,경기도 평택시 중앙동,46722,16590,23344,23378
4122052000,41220520,3107052,경기도 평택시 서정동,31821,12937,15865,15956
4122053500,41220535,3107053,경기도 평택시 송탄동,9895,3856,5302,4593
4122055000,41220550,3107055,경기도 평택시 지산동,10337,4158,5236,5101
4122056000,41220560,3107056,경기도 평택시 송북동,21676,8096,10873,10803
4122057000,41220570,3107057,경기도 평택시 신장1동,5404,2713,2682,2722
4122058000,41220580,3107058,경기도 평택시 신장2동,7946,3615,3976,3970
4122059000,41220590,3107059,경기도 평택시 신평동,22883,9305,11310,11573
4122060000,41220600,3107060,경기도 평택시 원평동,13792,5536,6976,6816
4122061000,41220610,3107061,경기도 평택시 통복동,5342,2409,2684,2658
4122062000,41220620,3107062,경기도 평택시 비전1동,16963,6052,8568,8395
4122063000,41220630,3107063,경기도 평택시 비전2동,38637,12970,19286,19351
4122064000,41220640,3107064,경기도 평택시 세교동,25286,8468,12682,12604
4125000000,41250000,#N/A,경기도 동두천시 ,90670,36613,45541,45129
4125051000,41250510,3108051,경기도 동두천시 생연1동,6650,2655,3319,3331
4125052000,41250520,3108052,경기도 동두천시 생연2동,13203,5141,6529,6674
4125053500,41250535,3108053,경기도 동두천시 중앙동,6516,3167,3266,3250
4125055000,41250550,3108055,경기도 동두천시 보산동,3255,1572,1611,1644
4125056500,41250565,3108056,경기도 동두천시 불현동,21906,8466,11005,10901
4125056600,41250566,3108061,경기도 동두천시 송내동,23611,8972,11585,12026
4125058000,41250580,3108058,경기도 동두천시 소요동,8764,3682,4692,4072
4125060000,41250600,3108060,경기도 동두천시 상패동,6765,2958,3534,3231
4127000000,41270000,#N/A,경기도 안산시 ,708551,272991,362731,345820
4127100000,41271000,#N/A,경기도 안산시 상록구 ,377364,144217,191759,185605
4127151000,41271510,3109151,경기도 안산시 상록구 일동,25768,10536,13261,12507
4127151500,41271515,3109174,경기도 안산시 상록구 이동,28357,12624,14731,13626
4127152000,41271520,3109152,경기도 안산시 상록구 사1동,37040,15786,18944,18096
4127153000,41271530,3109153,경기도 안산시 상록구 사2동,36176,12601,18373,17803
4127153500,41271535,3109175,경기도 안산시 상록구 사3동,20305,7096,10411,9894
4127154000,41271540,3109154,경기도 안산시 상록구 본오1동,41687,16768,21270,20417
4127155000,41271550,3109155,경기도 안산시 상록구 본오2동,33393,12217,16585,16808
4127156000,41271560,3109156,경기도 안산시 상록구 본오3동,24904,9875,12423,12481
4127157000,41271570,3109157,경기도 안산시 상록구 부곡동,21982,8454,11261,10721
4127158000,41271580,3109158,경기도 안산시 상록구 월피동,46471,16993,23540,22931
4127159000,41271590,3109162,경기도 안산시 상록구 성포동,30917,9844,15375,15542
4127160000,41271600,3109171,경기도 안산시 상록구 반월동,21181,7955,10860,10321
4127161000,41271610,3109173,경기도 안산시 상록구 안산동,9183,3468,4725,4458
4127300000,41273000,#N/A,경기도 안산시 단원구 ,331187,128774,170972,160215
4127351000,41273510,3109259,경기도 안산시 단원구 와동,46706,19174,24287,22419
4127352000,41273520,3109260,경기도 안산시 단원구 고잔1동,24579,9262,12368,12211
4127353000,41273530,3109261,경기도 안산시 단원구 고잔2동,25345,9496,12684,12661
4127353500,41273535,3109273,경기도 안산시 단원구 호수동,44513,14110,22343,22170
4127354000,41273540,3109263,경기도 안산시 단원구 원곡본동,22298,11722,12601,9697
4127355000,41273550,3109264,경기도 안산시 단원구 원곡1동,10659,4595,5576,5083
4127356000,41273560,3109265,경기도 안산시 단원구 원곡2동,17006,5413,8581,8425
4127357000,41273570,3109266,경기도 안산시 단원구 초지동,50178,18464,25502,24676
4127358000,41273580,3109268,경기도 안산시 단원구 선부1동,19630,7690,10109,9521
4127359000,41273590,3109269,경기도 안산시 단원구 선부2동,26961,12210,14683,12278
4127360000,41273600,3109270,경기도 안산시 단원구 선부3동,36209,13280,18546,17663
4127361000,41273610,3109272,경기도 안산시 단원구 대부동,7103,3358,3692,3411
4128000000,41280000,#N/A,경기도 고양시 ,936973,352634,462876,474097
4128100000,41281000,#N/A,경기도 고양시 덕양구 ,385387,150336,192718,192669
4128151000,41281510,3110151,경기도 고양시 덕양구 주교동,20854,8525,10479,10375
4128152000,41281520,3110152,경기도 고양시 덕양구 원신동,2116,979,1159,957
4128153000,41281530,3110153,경기도 고양시 덕양구 흥도동,4068,1914,2215,1853
4128154000,41281540,3110154,경기도 고양시 덕양구 성사1동,16934,7517,8404,8530
4128155000,41281550,3110155,경기도 고양시 덕양구 성사2동,13577,4854,6709,6868
4128156000,41281560,3110156,경기도 고양시 덕양구 효자동,7962,3635,4237,3725
4128157000,41281570,3110157,경기도 고양시 덕양구 신도동,6016,2876,3195,2821
4128158000,41281580,3110158,경기도 고양시 덕양구 창릉동,4908,2397,2738,2170
4128159000,41281590,3110159,경기도 고양시 덕양구 고양동,29392,11186,14804,14588
4128160000,41281600,3110160,경기도 고양시 덕양구 관산동,26776,10741,13576,13200
4128161000,41281610,3110161,경기도 고양시 덕양구 능곡동,20331,8080,10227,10104
4128162100,41281621,3110162,경기도 고양시 덕양구 화정1동,44829,16854,21781,23048
4128162200,41281622,3110163,경기도 고양시 덕양구 화정2동,37751,12892,18463,19288
4128163000,41281630,3110164,경기도 고양시 덕양구 행주동,24088,10610,12217,11871
4128164000,41281640,3110165,경기도 고양시 덕양구 행신1동,24830,8731,12124,12706
4128165000,41281650,3110166,경기도 고양시 덕양구 행신2동,39106,13865,19306,19800
4128165500,41281655,3110169,경기도 고양시 덕양구 행신3동,47340,17806,23278,24062
4128166000,41281660,3110167,경기도 고양시 덕양구 화전동,9677,4711,5232,4445
4128167000,41281670,3110168,경기도 고양시 덕양구 대덕동,4832,2163,2574,2258
4128500000,41285000,#N/A,경기도 고양시 일산동구 ,260912,99885,127909,133003
4128551000,41285510,3110351,경기도 고양시 일산동구 식사동,6944,2710,3565,3379
4128552000,41285520,3110352,경기도 고양시 일산동구 중산동,43362,15716,21172,22190
4128553000,41285530,3110353,경기도 고양시 일산동구 정발산동,30266,11117,14604,15662
4128554000,41285540,3110354,경기도 고양시 일산동구 풍산동,37946,13359,18653,19293
4128555100,41285551,3110355,경기도 고양시 일산동구 백석1동,29028,11038,14092,14936
4128555200,41285552,3110361,경기도 고양시 일산동구 백석2동,22013,10041,10687,11326
4128556000,41285560,3110356,경기도 고양시 일산동구 마두1동,29106,9634,14175,14931
4128557000,41285570,3110357,경기도 고양시 일산동구 마두2동,18699,6243,9022,9677
4128558000,41285580,3110358,경기도 고양시 일산동구 장항1동,3350,1546,1852,1498
4128559000,41285590,3110359,경기도 고양시 일산동구 장항2동,25528,12461,12328,13200
4128560000,41285600,3110360,경기도 고양시 일산동구 고봉동,14670,6020,7759,6911
4128700000,41287000,#N/A,경기도 고양시 일산서구 ,290674,102413,142249,148425
4128751000,41287510,3110451,경기도 고양시 일산서구 일산1동,30629,10417,15007,15622
4128752000,41287520,3110452,경기도 고양시 일산서구 일산2동,23217,9092,11492,11725
4128753000,41287530,3110453,경기도 고양시 일산서구 일산3동,42122,13063,20613,21509
4128754000,41287540,3110454,경기도 고양시 일산서구 탄현동,42522,14554,20850,21672
4128755000,41287550,3110455,경기도 고양시 일산서구 주엽1동,33151,11474,15961,17190
4128756000,41287560,3110456,경기도 고양시 일산서구 주엽2동,35030,12777,16669,18361
4128757000,41287570,3110457,경기도 고양시 일산서구 대화동,36148,13922,17674,18474
4128758000,41287580,3110458,경기도 고양시 일산서구 송포동,18206,6168,9073,9133
4128759000,41287590,3110459,경기도 고양시 일산서구 송산동,29649,10946,14910,14739
4129000000,41290000,#N/A,경기도 과천시 ,67507,24631,33205,34302
4129051000,41290510,3111051,경기도 과천시 중앙동,10768,3794,5241,5527
4129052000,41290520,3111052,경기도 과천시 갈현동,10353,3959,5069,5284
4129053000,41290530,3111053,경기도 과천시 별양동,16685,5678,8171,8514
4129054000,41290540,3111054,경기도 과천시 부림동,15001,5240,7340,7661
4129055000,41290550,3111055,경기도 과천시 과천동,7840,3311,4053,3787
4129056000,41290560,3111056,경기도 과천시 문원동,6860,2649,3331,3529
4131000000,41310000,#N/A,경기도 구리시 ,196077,73339,97782,98295
4131051000,41310510,3112051,경기도 구리시 갈매동,3099,1486,1652,1447
4131052000,41310520,3112052,경기도 구리시 동구동,44232,14853,21994,22238
4131053000,41310530,3112053,경기도 구리시 인창동,26523,9586,13234,13289
4131054100,41310541,3112054,경기도 구리시 교문1동,16481,7387,8336,8145
4131054200,41310542,3112055,경기도 구리시 교문2동,25933,8390,12711,13222
4131057000,41310570,3112056,경기도 구리시 수택1동,25548,10691,12687,12861
4131058000,41310580,3112057,경기도 구리시 수택2동,29595,11676,14780,14815
4131059000,41310590,3112058,경기도 구리시 수택3동,24666,9270,12388,12278
4136000000,41360000,#N/A,경기도 남양주시 ,502211,186046,251870,250341
4136025000,41360250,3113011,경기도 남양주시 와부읍,71567,25920,35388,36179
4136025300,41360253,3113012,경기도 남양주시 진접읍,49000,18554,25300,23700
4136025600,41360256,3113013,경기도 남양주시 화도읍,80470,30607,40698,39772
4136025900,41360259,3113014,경기도 남양주시 진건읍,30369,11293,15446,14923
4136026200,41360262,3113015,경기도 남양주시 오남읍,48872,17507,24340,24532
4136031000,41360310,3113031,경기도 남양주시 별내면,25092,9787,12565,12527
4136034000,41360340,3113034,경기도 남양주시 수동면,7808,3355,4043,3765
4136036000,41360360,3113035,경기도 남양주시 조안면,3962,1600,2038,1924
4136037000,41360370,3113032,경기도 남양주시 퇴계원면,29800,10714,14858,14942
4136051000,41360510,3113051,경기도 남양주시 호평동,33634,11873,16520,17114
4136052000,41360520,3113052,경기도 남양주시 평내동,41282,14679,20292,20990
4136053000,41360530,3113053,경기도 남양주시 금곡동,23096,8965,11677,11419
4136054000,41360540,3113054,경기도 남양주시 양정동,6301,2803,3423,2878
4136055000,41360550,3113055,경기도 남양주시 지금동,13118,5498,6678,6440
4136056000,41360560,3113056,경기도 남양주시 도농동,37840,12891,18604,19236
4137000000,41370000,#N/A,경기도 오산시 ,149086,57816,76037,73049
4137051000,41370510,3114051,경기도 오산시 중앙동,29957,11007,14986,14971
4137053000,41370530,3114053,경기도 오산시 남촌동,21405,11290,11694,9711
4137054000,41370540,3114054,경기도 오산시 신장동,22366,8593,11382,10984
4137055000,41370550,3114055,경기도 오산시 세마동,4686,2011,2445,2241
4137056000,41370560,3114056,경기도 오산시 초평동,15320,5452,7755,7565
4137057000,41370570,3114052,경기도 오산시 대원동,55352,19463,27775,27577
4139000000,41390000,#N/A,경기도 시흥시 ,391159,150709,204343,186816
4139051000,41390510,3115051,경기도 시흥시 대야동,37182,13417,18963,18219
4139052000,41390520,3115052,경기도 시흥시 신천동,42976,16309,21980,20996
4139053100,41390531,3115053,경기도 시흥시 신현동,12502,4755,6477,6025
4139054000,41390540,3115054,경기도 시흥시 은행동,33151,10684,16740,16411
4139055000,41390550,3115055,경기도 시흥시 매화동,13948,5074,7154,6794
4139057000,41390570,3115056,경기도 시흥시 목감동,12591,4916,6463,6128
4139058100,41390581,3115057,경기도 시흥시 군자동,41604,16003,21452,20152
4139058900,41390589,3115064,경기도 시흥시 정왕본동,23890,14825,14302,9588
4139059100,41390591,3115065,경기도 시흥시 정왕1동,33920,16945,19296,14624
4139059200,41390592,3115061,경기도 시흥시 정왕2동,37607,12841,19423,18184
4139059300,41390593,3115062,경기도 시흥시 정왕3동,25988,10223,13800,12188
4139059400,41390594,3115063,경기도 시흥시 정왕4동,25562,8144,12771,12791
4139062100,41390621,3115059,경기도 시흥시 과림동,2498,1267,1502,996
4139063000,41390630,3115060,경기도 시흥시 연성동,47740,15306,24020,23720
4141000000,41410000,#N/A,경기도 군포시 ,276992,101191,138445,138547
4141051000,41410510,3116051,경기도 군포시 군포1동,34595,13675,18083,16512
4141052000,41410520,3116052,경기도 군포시 군포2동,39503,13097,19813,19690
4141054000,41410540,3116054,경기도 군포시 산본1동,22899,9836,11375,11524
4141055000,41410550,3116055,경기도 군포시 산본2동,22960,7688,11427,11533
4141056000,41410560,3116056,경기도 군포시 금정동,21184,8762,10957,10227
4141057000,41410570,3116057,경기도 군포시 재궁동,24789,9385,12124,12665
4141058000,41410580,3116058,경기도 군포시 오금동,27086,9485,13429,13657
4141059000,41410590,3116059,경기도 군포시 수리동,21787,7870,10727,11060
4141060000,41410600,3116060,경기도 군포시 궁내동,23795,7625,11762,12033
4141061000,41410610,3116062,경기도 군포시 대야동,9353,3304,4742,4611
4141062000,41410620,3116061,경기도 군포시 광정동,29041,10464,14006,15035
4143000000,41430000,#N/A,경기도 의왕시 ,134416,49630,67729,66687
4143051000,41430510,3117051,경기도 의왕시 고천동,13908,5180,7121,6787
4143052000,41430520,3117052,경기도 의왕시 부곡동,28125,10376,14182,13943
4143053000,41430530,3117053,경기도 의왕시 오전동,43337,15038,21838,21499
4143054000,41430540,3117054,경기도 의왕시 내손1동,14431,5624,7205,7226
4143055000,41430550,3117055,경기도 의왕시 내손2동,24358,9526,12246,12112
4143056000,41430560,3117056,경기도 의왕시 청계동,10257,3886,5137,5120
4145000000,41450000,#N/A,경기도 하남시 ,142409,54906,72891,69518
4145051000,41450510,3118051,경기도 하남시 천현동,8190,3507,4397,3793
4145052000,41450520,3118052,경기도 하남시 신장1동,7815,3358,3962,3853
4145053000,41450530,3118053,경기도 하남시 신장2동,45730,16029,22942,22788
4145054000,41450540,3118054,경기도 하남시 덕풍1동,19426,7059,9791,9635
4145055000,41450550,3118055,경기도 하남시 덕풍2동,23798,9194,11998,11800
4145056000,41450560,3118056,경기도 하남시 덕풍3동,16184,6070,8146,8038
4145057000,41450570,3118057,경기도 하남시 풍산동,7041,3392,3851,3190
4145058000,41450580,3118058,경기도 하남시 감북동,5833,2532,3167,2666
4145059000,41450590,3118059,경기도 하남시 춘궁동,4029,1778,2208,1821
4145060000,41450600,3118060,경기도 하남시 초이동,4363,1987,2429,1934
4146000000,41460000,#N/A,경기도 용인시 ,814929,302291,406199,408730
4146100000,41461000,#N/A,경기도 용인시 처인구 ,203892,78984,104400,99492
4146125000,41461250,3119111,경기도 용인시 처인구 포곡읍,32062,12138,16449,15613
4146131000,41461310,3119131,경기도 용인시 처인구 모현면,22144,8841,11649,10495
4146132000,41461320,3119132,경기도 용인시 처인구 남사면,7474,3099,3917,3557
4146133000,41461330,3119133,경기도 용인시 처인구 이동면,17095,6753,8757,8338
4146134000,41461340,3119134,경기도 용인시 처인구 원삼면,7528,3195,3889,3639
4146135000,41461350,3119135,경기도 용인시 처인구 백암면,9245,4009,4757,4488
4146136000,41461360,3119136,경기도 용인시 처인구 양지면,14517,5626,7512,7005
4146151000,41461510,3119151,경기도 용인시 처인구 중앙동,22015,8853,11063,10952
4146152000,41461520,3119152,경기도 용인시 처인구 역삼동,24786,9348,12512,12274
4146153000,41461530,3119153,경기도 용인시 처인구 유림동,32658,11518,16588,16070
4146154000,41461540,3119154,경기도 용인시 처인구 동부동,14368,5604,7307,7061
4146300000,41463000,#N/A,경기도 용인시 기흥구 ,313355,117336,155409,157946
4146351000,41463510,3119251,경기도 용인시 기흥구 신갈동,48015,18202,23917,24098
4146352000,41463520,3119252,경기도 용인시 기흥구 구갈동,26495,10724,13374,13121
4146353000,41463530,3119253,경기도 용인시 기흥구 상갈동,44188,16539,22156,22032
4146354000,41463540,3119254,경기도 용인시 기흥구 기흥동,13276,5283,6805,6471
4146355000,41463550,3119255,경기도 용인시 기흥구 서농동,9740,5341,5071,4669
4146356000,41463560,3119256,경기도 용인시 기흥구 구성동,30158,11064,14786,15372
4146357000,41463570,3119257,경기도 용인시 기흥구 마북동,28657,10252,14206,14451
4146358500,41463585,3119258,경기도 용인시 기흥구 동백동,61160,21497,29918,31242
4146358600,41463586,3119260,경기도 용인시 기흥구 상하동,19428,6910,9500,9928
4146359000,41463590,3119259,경기도 용인시 기흥구 보정동,32238,11524,15676,16562
4146500000,41465000,#N/A,경기도 용인시 수지구 ,297682,105971,146390,151292
4146551000,41465510,3119351,경기도 용인시 수지구 풍덕천1동,36564,13864,18216,18348
4146552000,41465520,3119352,경기도 용인시 수지구 풍덕천2동,40614,14069,20110,20504
4146553000,41465530,3119353,경기도 용인시 수지구 신봉동,26455,9316,12922,13533
4146554000,41465540,3119354,경기도 용인시 수지구 죽전1동,58622,21017,28628,29994
4146555000,41465550,3119355,경기도 용인시 수지구 죽전2동,20598,7834,10218,10380
4146556000,41465560,3119356,경기도 용인시 수지구 동천동,25231,9219,12555,12676
4146557000,41465570,3119357,경기도 용인시 수지구 상현1동,32193,10823,15693,16500
4146558000,41465580,3119358,경기도 용인시 수지구 상현2동,32834,11084,16074,16760
4146559000,41465590,3119359,경기도 용인시 수지구 성복동,24571,8745,11974,12597
4148000000,41480000,#N/A,경기도 파주시 ,310182,123829,158121,152061
4148025000,41480250,3120011,경기도 파주시 문산읍,34870,13993,17553,17317
4148025300,41480253,3120012,경기도 파주시 파주읍,13212,5750,6859,6353
4148025600,41480256,3120013,경기도 파주시 법원읍,14306,5850,7478,6828
4148025900,41480259,3120014,경기도 파주시 교하읍,75905,27553,37794,38111
4148026200,41480262,3120015,경기도 파주시 조리읍,31521,11780,16030,15491
4148031000,41480310,3120031,경기도 파주시 월롱면,10717,7146,6235,4482
4148032000,41480320,3120032,경기도 파주시 탄현면,13432,6053,7075,6357
4148035000,41480350,3120035,경기도 파주시 광탄면,13458,5666,7071,6387
4148036000,41480360,3120036,경기도 파주시 파평면,5011,2089,2563,2448
4148037000,41480370,3120037,경기도 파주시 적성면,8412,3334,4360,4052
4148040000,41480400,3120021,경기도 파주시 진동면,147,55,75,72
4148051000,41480510,3120051,경기도 파주시 금촌1동,36531,13895,18709,17822
4148052000,41480520,3120052,경기도 파주시 금촌2동,52660,20665,26319,26341
4150000000,41500000,#N/A,경기도 이천시 ,196214,74279,99525,96689
4150025000,41500250,3121011,경기도 이천시 장호원읍,15856,6050,8086,7770
4150025300,41500253,3121012,경기도 이천시 부발읍,34276,13116,16822,17454
4150031000,41500310,3121031,경기도 이천시 신둔면,10985,4191,5654,5331
4150032000,41500320,3121032,경기도 이천시 백사면,10381,3806,5342,5039
4150033000,41500330,3121033,경기도 이천시 호법면,4884,1867,2552,2332
4150034000,41500340,3121034,경기도 이천시 마장면,8059,3389,4216,3843
4150035000,41500350,3121035,경기도 이천시 대월면,14717,5270,7503,7214
4150036000,41500360,3121036,경기도 이천시 모가면,5101,2081,2684,2417
4150037000,41500370,3121037,경기도 이천시 설성면,5589,2258,2843,2746
4150038000,41500380,3121038,경기도 이천시 율면,3107,1346,1565,1542
4150051000,41500510,3121051,경기도 이천시 창전동,20653,8089,10072,10581
4150051500,41500515,3121054,경기도 이천시 증포동,36935,11765,18345,18590
4150052000,41500520,3121052,경기도 이천시 중리동,15255,6995,8695,6560
4150053000,41500530,3121053,경기도 이천시 관고동,10416,4056,5146,5270
4155000000,41550000,#N/A,경기도 안성시 ,169331,67035,86152,83179
4155025000,41550250,3122011,경기도 안성시 공도읍,46302,17819,23230,23072
4155031000,41550310,3122031,경기도 안성시 보개면,6300,2528,3208,3092
4155032000,41550320,3122032,경기도 안성시 금광면,8705,3351,4400,4305
4155033000,41550330,3122033,경기도 안성시 서운면,4088,1653,2143,1945
4155034000,41550340,3122034,경기도 안성시 미양면,6900,2759,3634,3266
4155035000,41550350,3122035,경기도 안성시 대덕면,10684,5668,5893,4791
4155036000,41550360,3122036,경기도 안성시 양성면,5484,2245,2761,2723
4155038000,41550380,3122038,경기도 안성시 원곡면,5044,2050,2605,2439
4155039000,41550390,3122039,경기도 안성시 일죽면,8717,3495,4444,4273
4155040000,41550400,3122040,경기도 안성시 죽산면,7825,3321,4009,3816
4155041000,41550410,3122041,경기도 안성시 삼죽면,3598,1576,1865,1733
4155042000,41550420,3122042,경기도 안성시 고삼면,2160,905,1127,1033
4155051000,41550510,3122051,경기도 안성시 안성1동,13478,5128,6745,6733
4155052000,41550520,3122052,경기도 안성시 안성2동,16013,6237,8049,7964
4155053000,41550530,3122053,경기도 안성시 안성3동,24033,8300,12039,11994
4157000000,41570000,#N/A,경기도 김포시 ,219395,82474,111285,108110
4157025000,41570250,3123011,경기도 김포시 통진읍,22958,9519,11951,11007
4157031000,41570310,3123031,경기도 김포시 고촌면,22097,8094,11160,10937
4157032000,41570320,3123032,경기도 김포시 양촌면,13154,5823,6862,6292
4157034000,41570340,3123034,경기도 김포시 대곶면,10727,4860,5900,4827
4157035000,41570350,3123035,경기도 김포시 월곶면,6197,2960,3364,2833
4157036000,41570360,3123036,경기도 김포시 하성면,9616,4051,5028,4588
4157051000,41570510,3123051,경기도 김포시 김포1동,46565,16253,23315,23250
4157052000,41570520,3123052,경기도 김포시 김포2동,27815,9737,13652,14163
4157054000,41570540,3123053,경기도 김포시 사우동,22863,8814,11454,11409
4157055000,41570550,3123054,경기도 김포시 풍무동,37403,12363,18599,18804
4159000000,41590000,#N/A,경기도 화성시 ,434013,164209,224548,209465
4159025300,41590253,3124012,경기도 화성시 봉담읍,55640,20027,28448,27192
4159025600,41590256,3124013,경기도 화성시 우정읍,17793,7321,9524,8269
4159025900,41590259,3124014,경기도 화성시 향남읍,24458,10056,12891,11567
4159031000,41590310,3124031,경기도 화성시 매송면,7834,3117,4066,3768
4159032000,41590320,3124033,경기도 화성시 비봉면,6411,2793,3480,2931
4159033000,41590330,3124035,경기도 화성시 마도면,5511,2439,2983,2528
4159034000,41590340,3124036,경기도 화성시 송산면,10585,4588,5523,5062
4159035000,41590350,3124037,경기도 화성시 서신면,6510,3078,3456,3054
4159036000,41590360,3124038,경기도 화성시 팔탄면,10283,5002,5839,4444
4159037000,41590370,3124039,경기도 화성시 장안면,11661,4874,6295,5366
4159040000,41590400,3124042,경기도 화성시 양감면,4434,2094,2557,1877
4159041000,41590410,3124043,경기도 화성시 정남면,13380,5988,7332,6048
4159042000,41590420,3124044,경기도 화성시 동탄면,13306,5713,7098,6208
4159051000,41590510,3124051,경기도 화성시 남양동,22769,9503,12110,10659
4159052000,41590520,3124052,경기도 화성시 진안동,33097,13407,17139,15958
4159053000,41590530,3124053,경기도 화성시 병점1동,26829,8876,13550,13279
4159054000,41590540,3124054,경기도 화성시 병점2동,25884,8835,12693,13191
4159055000,41590550,3124055,경기도 화성시 반월동,19538,6241,9937,9601
4159056000,41590560,3124056,경기도 화성시 기배동,14892,4831,7604,7288
4159057000,41590570,3124057,경기도 화성시 화산동,23851,8757,12352,11499
4159058500,41590585,3124059,경기도 화성시 동탄1동,56456,19827,28226,28230
4159058600,41590586,3124060,경기도 화성시 동탄2동,22891,6842,11445,11446
4161000000,41610000,#N/A,경기도 광주시 ,234241,89138,120392,113849
4161025000,41610250,3125011,경기도 광주시 오포읍,52807,19912,27076,25731
4161025300,41610253,3125012,경기도 광주시 초월읍,34581,12911,17865,16716
4161025600,41610256,3125013,경기도 광주시 실촌읍,23352,9430,12173,11179
4161033000,41610330,3125034,경기도 광주시 도척면,8453,3371,4441,4012
4161034000,41610340,3125035,경기도 광주시 퇴촌면,9855,4226,5050,4805
4161035000,41610350,3125036,경기도 광주시 남종면,1855,794,953,902
4161036000,41610360,3125037,경기도 광주시 중부면,2627,1103,1378,1249
4161051000,41610510,3125051,경기도 광주시 경안동,34305,12886,17524,16781
4161052000,41610520,3125052,경기도 광주시 송정동,34502,12818,17483,17019
4161053000,41610530,3125053,경기도 광주시 광남동,31904,11687,16449,15455
4163000000,41630000,#N/A,경기도 양주시 ,180205,69008,92354,87851
4163025000,41630250,3126011,경기도 양주시 백석읍,28195,10453,14377,13818
4163031000,41630310,3126031,경기도 양주시 은현면,7724,3295,4217,3507
4163032000,41630320,3126032,경기도 양주시 남면,7942,3490,4304,3638
4163033000,41630330,3126033,경기도 양주시 광적면,12301,5013,6610,5691
4163034000,41630340,3126034,경기도 양주시 장흥면,10738,4272,5533,5205
4163051000,41630510,3126051,경기도 양주시 양주1동,8010,3374,4146,3864
4163052000,41630520,3126052,경기도 양주시 양주2동,30579,10909,15200,15379
4163053000,41630530,3126053,경기도 양주시 회천1동,7919,3332,4168,3751
4163054000,41630540,3126054,경기도 양주시 회천2동,31184,11786,15852,15332
4163055000,41630550,3126055,경기도 양주시 회천3동,29657,10387,14798,14859
4163056000,41630560,3126056,경기도 양주시 회천4동,5956,2697,3149,2807
4165000000,41650000,#N/A,경기도 포천시 ,160138,64878,83181,76957
4165025000,41650250,3127011,경기도 포천시 소흘읍,47766,18300,24191,23575
4165031000,41650310,3127031,경기도 포천시 군내면,7165,2859,3825,3340
4165032000,41650320,3127032,경기도 포천시 내촌면,5508,2517,3029,2479
4165033000,41650330,3127033,경기도 포천시 가산면,8937,3772,4918,4019
4165034000,41650340,3127034,경기도 포천시 신북면,14169,5983,7496,6673
4165035000,41650350,3127035,경기도 포천시 창수면,2914,1271,1577,1337
4165036000,41650360,3127036,경기도 포천시 영중면,5903,2480,3085,2818
4165037000,41650370,3127037,경기도 포천시 일동면,11109,4518,5783,5326
4165038000,41650380,3127038,경기도 포천시 이동면,6311,2828,3392,2919
4165039000,41650390,3127039,경기도 포천시 영북면,9910,4259,5160,4750
4165040000,41650400,3127040,경기도 포천시 관인면,4200,1811,2188,2012
4165041000,41650410,3127041,경기도 포천시 화현면,3118,1280,1596,1522
4165051000,41650510,3127051,경기도 포천시 포천동,19331,7152,9679,9652
4165052000,41650520,3127052,경기도 포천시 선단동,13797,5848,7262,6535
4173000000,41730000,#N/A,경기도 여주군 ,107169,41730,54094,53075
4173025000,41730250,3132011,경기도 여주군 여주읍,51145,18925,25585,25560
4173031000,41730310,3132031,경기도 여주군 점동면,4860,1936,2500,2360
4173032000,41730320,3132032,경기도 여주군 가남면,16280,6443,8288,7992
4173033000,41730330,3132034,경기도 여주군 흥천면,5448,2209,2819,2629
4173034000,41730340,3132035,경기도 여주군 금사면,3015,1354,1487,1528
4173035000,41730350,3132033,경기도 여주군 능서면,6964,2791,3540,3424
4173036000,41730360,3132037,경기도 여주군 대신면,7994,3349,4075,3919
4173037000,41730370,3132038,경기도 여주군 북내면,5298,2131,2712,2586
4173038000,41730380,3132039,경기도 여주군 강천면,3666,1550,1848,1818
4173039000,41730390,3132036,경기도 여주군 산북면,2499,1042,1240,1259
4180000000,41800000,#N/A,경기도 연천군 ,45575,19216,23468,22107
4180025000,41800250,3135011,경기도 연천군 연천읍,7189,3054,3712,3477
4180025300,41800253,3135012,경기도 연천군 전곡읍,19441,7716,9924,9517
4180031000,41800310,3135031,경기도 연천군 군남면,3731,1612,1961,1770
4180032000,41800320,3135032,경기도 연천군 청산면,4521,2104,2321,2200
4180033000,41800330,3135033,경기도 연천군 백학면,2961,1191,1540,1421
4180034000,41800340,3135034,경기도 연천군 미산면,1782,785,908,874
4180035000,41800350,3135035,경기도 연천군 왕징면,1279,584,676,603
4180036000,41800360,3135036,경기도 연천군 신서면,3720,1773,1938,1782
4180037000,41800370,3135037,경기도 연천군 중면,286,116,150,136
4180038000,41800380,3135038,경기도 연천군 장남면,665,281,338,327
4182000000,41820000,#N/A,경기도 가평군 ,57116,23747,29129,27987
4182025000,41820250,3137011,경기도 가평군 가평읍,19198,7709,9739,9459
4182031000,41820310,3137031,경기도 가평군 설악면,7041,3136,3597,3444
4182032500,41820325,3137032,경기도 가평군 청평면,12951,5710,6548,6403
4182033000,41820330,3137033,경기도 가평군 상면,4964,2230,2535,2429
4182034000,41820340,3137034,경기도 가평군 하면,9401,3233,4916,4485
4182035000,41820350,3137035,경기도 가평군 북면,3561,1729,1794,1767
4183000000,41830000,#N/A,경기도 양평군 ,89748,38719,45358,44390
4183025000,41830250,3138011,경기도 양평군 양평읍,25419,10190,12705,12714
4183031000,41830310,3138031,경기도 양평군 강상면,4965,2081,2520,2445
4183032000,41830320,3138032,경기도 양평군 강하면,3768,1726,1861,1907
4183033000,41830330,3138033,경기도 양평군 양서면,9266,4020,4717,4549
4183034000,41830340,3138034,경기도 양평군 옥천면,6099,2733,3112,2987
4183035000,41830350,3138035,경기도 양평군 서종면,6464,3075,3221,3243
4183036000,41830360,3138036,경기도 양평군 단월면,3176,1439,1629,1547
4183037000,41830370,3138037,경기도 양평군 청운면,3573,1624,1799,1774
4183038000,41830380,3138038,경기도 양평군 양동면,4599,2005,2359,2240
4183039500,41830395,3138039,경기도 양평군 지평면,5913,2664,2990,2923
4183040000,41830400,3138040,경기도 양평군 용문면,12238,5257,6263,5975
4183041000,41830410,3138041,경기도 양평군 개군면,4268,1905,2182,2086
4200000000,42000000,#N/A,강원도  ,1507620,605201,758748,748872
4211000000,42110000,#N/A,강원도 춘천시 ,261913,101655,129303,132610
4211025000,42110250,3201011,강원도 춘천시 신북읍,7543,2930,3832,3711
4211031000,42110310,3201031,강원도 춘천시 동면,5991,2214,3093,2898
4211032000,42110320,3201032,강원도 춘천시 동산면,1623,691,824,799
4211033000,42110330,3201033,강원도 춘천시 신동면,2617,951,1307,1310
4211034000,42110340,3201035,강원도 춘천시 남면,1121,545,580,541
4211035000,42110350,3201037,강원도 춘천시 서면,4151,1778,2039,2112
4211036000,42110360,3201038,강원도 춘천시 사북면,2612,1180,1286,1326
4211038000,42110380,3201039,강원도 춘천시 북산면,885,487,480,405
4211039000,42110390,3201034,강원도 춘천시 동내면,10582,3949,5398,5184
4211040000,42110400,3201036,강원도 춘천시 남산면,4000,1810,2076,1924
4211052000,42110520,3201052,강원도 춘천시 교동,4254,2019,2082,2172
4211053000,42110530,3201053,강원도 춘천시 조운동,3814,1776,1867,1947
4211054500,42110545,3201054,강원도 춘천시 약사명동,5144,2168,2568,2576
4211057000,42110570,3201057,강원도 춘천시 근화동,8224,3528,4196,4028
4211058000,42110580,3201058,강원도 춘천시 소양동,8249,3648,4028,4221
4211060000,42110600,3201060,강원도 춘천시 후평1동,13478,5628,6614,6864
4211061000,42110610,3201061,강원도 춘천시 후평2동,14547,5523,7012,7535
4211061100,42110611,3201062,강원도 춘천시 후평3동,21676,8103,10452,11224
4211062000,42110620,3201063,강원도 춘천시 효자1동,4232,1847,2139,2093
4211063000,42110630,3201064,강원도 춘천시 효자2동,13412,6388,6900,6512
4211064000,42110640,3201065,강원도 춘천시 효자3동,5129,2309,2575,2554
4211065000,42110650,3201066,강원도 춘천시 석사동,40497,14621,19590,20907
4211066000,42110660,3201067,강원도 춘천시 퇴계동,44236,15547,21582,22654
4211067500,42110675,3201068,강원도 춘천시 강남동,14572,5395,7114,7458
4211070500,42110705,3201071,강원도 춘천시 신사우동,19324,6620,9669,9655
4213000000,42130000,#N/A,강원도 원주시 ,303343,116211,151367,151976
4213025000,42130250,3202011,강원도 원주시 문막읍,18530,7282,9453,9077
4213031000,42130310,3202031,강원도 원주시 소초면,10119,4049,5241,4878
4213032000,42130320,3202032,강원도 원주시 호저면,4686,1930,2422,2264
4213033000,42130330,3202033,강원도 원주시 지정면,3464,1472,1812,1652
4213035000,42130350,3202034,강원도 원주시 부론면,2695,1237,1369,1326
4213036000,42130360,3202035,강원도 원주시 귀래면,2153,958,1122,1031
4213037000,42130370,3202036,강원도 원주시 흥업면,6095,2820,3251,2844
4213038000,42130380,3202037,강원도 원주시 판부면,6301,2748,3235,3066
4213039000,42130390,3202038,강원도 원주시 신림면,3931,1764,1990,1941
4213051500,42130515,3202051,강원도 원주시 중앙동,3762,1815,1979,1783
4213052000,42130520,3202052,강원도 원주시 원인동,7881,3229,3781,4100
4213053000,42130530,3202053,강원도 원주시 개운동,12868,4631,6277,6591
4213054100,42130541,3202054,강원도 원주시 명륜1동,12106,4368,5875,6231
4213054200,42130542,3202055,강원도 원주시 명륜2동,19902,7550,9517,10385
4213055000,42130550,3202056,강원도 원주시 단구동,45305,16062,22366,22939
4213056000,42130560,3202057,강원도 원주시 일산동,9253,3806,4635,4618
4213057500,42130575,3202058,강원도 원주시 학성동,6910,2846,3475,3435
4213059000,42130590,3202060,강원도 원주시 단계동,25264,9400,12238,13026
4213060000,42130600,3202061,강원도 원주시 우산동,10329,4446,5380,4949
4213061000,42130610,3202062,강원도 원주시 태장1동,11036,3886,5528,5508
4213062000,42130620,3202063,강원도 원주시 태장2동,26965,10021,13566,13399
4213063500,42130635,3202064,강원도 원주시 봉산동,11865,4532,5960,5905
4213065000,42130650,3202066,강원도 원주시 행구동,6023,2141,2969,3054
4213066000,42130660,3202067,강원도 원주시 무실동,19654,7254,9769,9885
4213067500,42130675,3202068,강원도 원주시 반곡관설동,16246,5964,8157,8089
4215000000,42150000,#N/A,강원도 강릉시 ,218684,86861,109024,109660
4215025000,42150250,3203011,강원도 강릉시 주문진읍,20867,8938,10454,10413
4215031000,42150310,3203031,강원도 강릉시 성산면,3345,1418,1725,1620
4215032000,42150320,3203032,강원도 강릉시 왕산면,1758,831,955,803
4215033000,42150330,3203033,강원도 강릉시 구정면,3996,1583,2030,1966
4215034000,42150340,3203034,강원도 강릉시 강동면,5389,2399,2680,2709
4215035000,42150350,3203035,강원도 강릉시 옥계면,4484,1892,2237,2247
4215036000,42150360,3203036,강원도 강릉시 사천면,4202,1871,2171,2031
4215037000,42150370,3203037,강원도 강릉시 연곡면,6162,2658,3090,3072
4215051000,42150510,3203051,강원도 강릉시 홍제동,8999,3602,4435,4564
4215052000,42150520,3203052,강원도 강릉시 중앙동,6839,3207,3302,3537
4215054000,42150540,3203054,강원도 강릉시 옥천동,4768,2295,2380,2388
4215055000,42150550,3203055,강원도 강릉시 교1동,28523,10410,13897,14626
4215056000,42150560,3203056,강원도 강릉시 교2동,10118,4076,5086,5032
4215057100,42150571,3203057,강원도 강릉시 포남1동,12661,5104,6275,6386
4215057200,42150572,3203058,강원도 강릉시 포남2동,17359,6705,8503,8856
4215058000,42150580,3203059,강원도 강릉시 초당동,6027,2302,3002,3025
4215059000,42150590,3203060,강원도 강릉시 송정동,7654,2781,3805,3849
4215060000,42150600,3203061,강원도 강릉시 내곡동,11101,4100,5668,5433
4215061500,42150615,3203062,강원도 강릉시 강남동,21018,7957,10613,10405
4215064500,42150645,3203065,강원도 강릉시 성덕동,28434,10603,14131,14303
4215066500,42150665,3203067,강원도 강릉시 경포동,4980,2129,2585,2395
4217000000,42170000,#N/A,강원도 동해시 ,95814,37493,48430,47384
4217051000,42170510,3204051,강원도 동해시 천곡동,27476,10358,13648,13828
4217052000,42170520,3204052,강원도 동해시 송정동,4936,2204,2647,2289
4217053000,42170530,3204053,강원도 동해시 북삼동,21200,7401,10880,10320
4217054000,42170540,3204054,강원도 동해시 부곡동,7396,2972,3708,3688
4217055000,42170550,3204055,강원도 동해시 동호동,5291,2240,2664,2627
4217057000,42170570,3204057,강원도 동해시 발한동,5608,2463,2802,2806
4217059000,42170590,3204059,강원도 동해시 묵호동,4814,2255,2396,2418
4217060000,42170600,3204060,강원도 동해시 북평동,10784,4106,5425,5359
4217063000,42170630,3204063,강원도 동해시 망상동,4255,1882,2194,2061
4217065000,42170650,3204065,강원도 동해시 삼화동,4054,1612,2066,1988
4219000000,42190000,#N/A,강원도 태백시 ,51180,21101,26163,25017
4219051500,42190515,3205051,강원도 태백시 황지동,7383,2926,3675,3708
4219052500,42190525,3205052,강원도 태백시 황연동,6334,2629,3335,2999
4219053500,42190535,3205053,강원도 태백시 삼수동,7679,3248,3939,3740
4219054000,42190540,3205054,강원도 태백시 상장동,14116,5646,7148,6968
4219058500,42190585,3205062,강원도 태백시 문곡소도동,3870,1621,1982,1888
4219059500,42190595,3205056,강원도 태백시 장성동,4650,1940,2351,2299
4219060500,42190605,3205055,강원도 태백시 구문소동,3841,1628,2026,1815
4219061500,42190615,3205058,강원도 태백시 철암동,3307,1463,1707,1600
4221000000,42210000,#N/A,강원도 속초시 ,84696,35589,41731,42965
4221051000,42210510,3206051,강원도 속초시 영랑동,6252,2798,3155,3097
4221052000,42210520,3206052,강원도 속초시 동명동,4361,2085,2229,2132
4221054000,42210540,3206054,강원도 속초시 금호동,7999,3567,3935,4064
4221056000,42210560,3206056,강원도 속초시 교동,13103,5383,6463,6640
4221057000,42210570,3206057,강원도 속초시 노학동,23466,9577,11430,12036
4221058000,42210580,3206058,강원도 속초시 조양동,20842,8178,10136,10706
4221059000,42210590,3206059,강원도 속초시 청호동,4709,2211,2358,2351
4221060000,42210600,3206060,강원도 속초시 대포동,3964,1790,2025,1939
4223000000,42230000,#N/A,강원도 삼척시 ,70479,29249,35620,34859
4223025000,42230250,3207011,강원도 삼척시 도계읍,12303,4928,6296,6007
4223025300,42230253,3207012,강원도 삼척시 원덕읍,5474,2567,2638,2836
4223031000,42230310,3207031,강원도 삼척시 근덕면,5867,2807,2901,2966
4223032000,42230320,3207032,강원도 삼척시 하장면,1562,647,854,708
4223033000,42230330,3207033,강원도 삼척시 노곡면,834,429,434,400
4223034000,42230340,3207034,강원도 삼척시 미로면,2127,898,1111,1016
4223035000,42230350,3207035,강원도 삼척시 가곡면,768,394,383,385
4223036000,42230360,3207036,강원도 삼척시 신기면,838,390,466,372
4223051000,42230510,3207051,강원도 삼척시 남양동,10192,4105,5057,5135
4223053000,42230530,3207053,강원도 삼척시 교동,9061,3306,4589,4472
4223054000,42230540,3207054,강원도 삼척시 정라동,12629,5213,6509,6120
4223057000,42230570,3207052,강원도 삼척시 성내동,8824,3565,4382,4442
4272000000,42720000,#N/A,강원도 홍천군 ,70310,28389,35813,34497
4272025000,42720250,3231011,강원도 홍천군 홍천읍,35858,13472,18062,17796
4272031000,42720310,3231031,강원도 홍천군 화촌면,4851,2083,2477,2374
4272032000,42720320,3231032,강원도 홍천군 두촌면,2492,1118,1247,1245
4272033000,42720330,3231033,강원도 홍천군 내촌면,2338,1046,1209,1129
4272034000,42720340,3231034,강원도 홍천군 서석면,4064,1619,2000,2064
4272035000,42720350,3231035,강원도 홍천군 동면,3583,1494,1846,1737
4272036000,42720360,3231036,강원도 홍천군 남면,6013,2583,3130,2883
4272037000,42720370,3231037,강원도 홍천군 서면,3399,1717,1805,1594
4272038000,42720380,3231038,강원도 홍천군 북방면,4094,1803,2148,1946
4272039000,42720390,3231039,강원도 홍천군 내면,3618,1454,1889,1729
4273000000,42730000,#N/A,강원도 횡성군 ,43289,17793,22097,21192
4273025000,42730250,3232011,강원도 횡성군 횡성읍,18569,7107,9371,9198
4273031000,42730310,3232031,강원도 횡성군 우천면,4564,1959,2308,2256
4273032000,42730320,3232032,강원도 횡성군 안흥면,2716,1103,1386,1330
4273033000,42730330,3232033,강원도 횡성군 둔내면,5466,2322,2845,2621
4273034000,42730340,3232034,강원도 횡성군 갑천면,2103,994,1090,1013
4273035000,42730350,3232035,강원도 횡성군 청일면,2396,1105,1186,1210
4273036000,42730360,3232036,강원도 횡성군 공근면,3760,1583,1984,1776
4273037000,42730370,3232037,강원도 횡성군 서원면,2249,960,1183,1066
4273038000,42730380,3232038,강원도 횡성군 강림면,1466,660,744,722
4275000000,42750000,#N/A,강원도 영월군 ,40072,17473,20341,19731
4275025000,42750250,3233011,강원도 영월군 영월읍,21792,8791,10969,10823
4275025300,42750253,3233012,강원도 영월군 상동읍,1296,642,657,639
4275031000,42750310,3233031,강원도 영월군 중동면,1583,722,796,787
4275032000,42750320,3233032,강원도 영월군 하동면,1662,841,856,806
4275033000,42750330,3233033,강원도 영월군 북면,2255,1083,1165,1090
4275034000,42750340,3233034,강원도 영월군 남면,2378,1128,1250,1128
4275035000,42750350,3233035,강원도 영월군 서면,3423,1574,1790,1633
4275036000,42750360,3233036,강원도 영월군 주천면,4044,1832,2025,2019
4275037000,42750370,3233037,강원도 영월군 수주면,1639,860,833,806
4276000000,42760000,#N/A,강원도 평창군 ,43774,18676,22441,21333
4276025000,42760250,3234011,강원도 평창군 평창읍,9276,3716,4633,4643
4276031000,42760310,3234031,강원도 평창군 미탄면,1894,868,992,902
4276032000,42760320,3234032,강원도 평창군 방림면,2431,1129,1224,1207
4276033000,42760330,3234033,강원도 평창군 대화면,5722,2447,2850,2872
4276034000,42760340,3234034,강원도 평창군 봉평면,5407,2383,2822,2585
4276035000,42760350,3234035,강원도 평창군 용평면,3049,1311,1550,1499
4276036000,42760360,3234036,강원도 평창군 진부면,9911,4056,5048,4863
4276038000,42760380,3234037,강원도 평창군 대관령면,6084,2766,3322,2762
4277000000,42770000,#N/A,강원도 정선군 ,41350,18200,21421,19929
4277025000,42770250,3235011,강원도 정선군 정선읍,11877,4672,6101,5776
4277025300,42770253,3235012,강원도 정선군 고한읍,5168,2928,2662,2506
4277025600,42770256,3235013,강원도 정선군 사북읍,6010,2525,3146,2864
4277025900,42770259,3235014,강원도 정선군 신동읍,4126,1846,2141,1985
4277031000,42770310,3235031,강원도 정선군 동면,1769,778,929,840
4277032000,42770320,3235032,강원도 정선군 남면,3356,1457,1769,1587
4277033000,42770330,3235033,강원도 정선군 북면,2320,1066,1194,1126
4277034000,42770340,3235034,강원도 정선군 북평면,2779,1207,1425,1354
4277035000,42770350,3235035,강원도 정선군 임계면,3945,1721,2054,1891
4278000000,42780000,#N/A,강원도 철원군 ,47688,18758,24760,22928
4278025000,42780250,3236011,강원도 철원군 철원읍,6103,2255,3146,2957
4278025300,42780253,3236012,강원도 철원군 김화읍,3455,1381,1829,1626
4278025600,42780256,3236013,강원도 철원군 갈말읍,13469,5270,7151,6318
4278025900,42780259,3236014,강원도 철원군 동송읍,15647,6092,7919,7728
4278031000,42780310,3236031,강원도 철원군 서면,6590,2732,3458,3132
4278032000,42780320,3236032,강원도 철원군 근남면,2282,969,1183,1099
4278033000,42780330,3236021,강원도 철원군 근북면,142,59,74,68
4279000000,42790000,#N/A,강원도 화천군 ,23777,10700,12938,10839
4279025000,42790250,3237011,강원도 화천군 화천읍,8406,3611,4430,3976
4279031000,42790310,3237031,강원도 화천군 간동면,2558,1224,1366,1192
4279032000,42790320,3237032,강원도 화천군 하남면,2149,895,1103,1046
4279033000,42790330,3237033,강원도 화천군 상서면,4799,2301,2828,1971
4279034000,42790340,3237034,강원도 화천군 사내면,5865,2669,3211,2654
4280000000,42800000,#N/A,강원도 양구군 ,21272,8790,11104,10168
4280025000,42800250,3238011,강원도 양구군 양구읍,12064,4909,6185,5879
4280031000,42800310,3238031,강원도 양구군 남면,3758,1589,1987,1771
4280032000,42800320,3238032,강원도 양구군 동면,2412,1001,1273,1139
4280033000,42800330,3238033,강원도 양구군 방산면,1613,736,899,714
4280034000,42800340,3238034,강원도 양구군 해안면,1425,555,760,665
4281000000,42810000,#N/A,강원도 인제군 ,31631,12980,16536,15095
4281025000,42810250,3239011,강원도 인제군 인제읍,9506,3763,4947,4559
4281031000,42810310,3239031,강원도 인제군 남면,4006,1701,2074,1932
4281032000,42810320,3239032,강원도 인제군 북면,8067,3304,4213,3854
4281033000,42810330,3239033,강원도 인제군 기린면,5074,2077,2660,2414
4281034000,42810340,3239034,강원도 인제군 서화면,3235,1370,1738,1497
4281035000,42810350,3239035,강원도 인제군 상남면,1743,765,904,839
4282000000,42820000,#N/A,강원도 고성군 ,30212,13075,15378,14834
4282025000,42820250,3240011,강원도 고성군 간성읍,7404,3017,3889,3515
4282025300,42820253,3240012,강원도 고성군 거진읍,7920,3515,3901,4019
4282031000,42820310,3240031,강원도 고성군 현내면,3160,1373,1549,1611
4282032000,42820320,3240032,강원도 고성군 죽왕면,4219,1784,2145,2074
4282033000,42820330,3240033,강원도 고성군 토성면,7509,3386,3894,3615
4283000000,42830000,#N/A,강원도 양양군 ,28136,12208,14281,13855
4283025000,42830250,3241011,강원도 양양군 양양읍,11710,4716,5945,5765
4283031000,42830310,3241031,강원도 양양군 서면,3279,1449,1676,1603
4283032000,42830320,3241032,강원도 양양군 손양면,2458,1088,1240,1218
4283033000,42830330,3241033,강원도 양양군 현북면,2882,1389,1458,1424
4283034000,42830340,3241034,강원도 양양군 현남면,3422,1595,1718,1704
4283035000,42830350,3241035,강원도 양양군 강현면,4385,1971,2244,2141
4300000000,43000000,#N/A,충청북도  ,1518621,586107,764851,753770
4311000000,43110000,#N/A,충청북도 청주시 ,637865,237136,317694,320171
4311100000,43111000,#N/A,충청북도 청주시 상당구 ,246823,90800,122764,124059
4311152500,43111525,3301151,충청북도 청주시 상당구 중앙동,7096,3120,3667,3429
4311154500,43111545,3301152,충청북도 청주시 상당구 성안동,7793,3625,3889,3904
4311158000,43111580,3301158,충청북도 청주시 상당구 우암동,14705,6265,7428,7277
4311159000,43111590,3301159,충청북도 청주시 상당구 내덕제1동,11727,4537,5907,5820
4311160000,43111600,3301160,충청북도 청주시 상당구 내덕제2동,12975,5251,6585,6390
4311161000,43111610,3301161,충청북도 청주시 상당구 율량.사천동,43323,14826,21221,22102
4311162000,43111620,3301162,충청북도 청주시 상당구 탑대성동,12625,4934,6275,6350
4311167000,43111670,3301163,충청북도 청주시 상당구 영운동,13154,5014,6605,6549
4311168000,43111680,3301164,충청북도 청주시 상당구 금천동,35805,12476,17692,18113
4311169000,43111690,3301165,충청북도 청주시 상당구 용담.명암.산성동,12345,4006,6056,6289
4311172000,43111720,3301166,충청북도 청주시 상당구 용암1동,43122,15579,21336,21786
4311173000,43111730,3301168,충청북도 청주시 상당구 용암2동,27984,9555,13952,14032
4311179000,43111790,3301167,충청북도 청주시 상당구 오근장동,4169,1612,2151,2018
4311300000,43113000,#N/A,충청북도 청주시 흥덕구 ,391042,146336,194930,196112
4311363000,43113630,3301251,충청북도 청주시 흥덕구 사직제1동,9448,4095,4872,4576
4311364000,43113640,3301252,충청북도 청주시 흥덕구 사직제2동,6565,2680,3292,3273
4311365000,43113650,3301253,충청북도 청주시 흥덕구 사창동,17405,7372,8577,8828
4311366000,43113660,3301254,충청북도 청주시 흥덕구 모충동,21011,8705,10491,10520
4311370000,43113700,3301255,충청북도 청주시 흥덕구 운천.신봉동,23270,8331,11580,11690
4311372200,43113722,3301267,충청북도 청주시 흥덕구 산남동,26081,8494,12983,13098
4311372300,43113723,3301268,충청북도 청주시 흥덕구 분평동,37702,12234,18504,19198
4311372700,43113727,3301257,충청북도 청주시 흥덕구 수곡1동,18140,7163,8973,9167
4311372800,43113728,3301258,충청북도 청주시 흥덕구 수곡2동,18923,7312,9443,9480
4311374100,43113741,3301260,충청북도 청주시 흥덕구 복대1동,36018,13907,18050,17968
4311374200,43113742,3301261,충청북도 청주시 흥덕구 복대2동,21674,8533,10774,10900
4311374700,43113747,3301262,충청북도 청주시 흥덕구 가경동,51537,17164,25300,26237
4311375100,43113751,3301263,충청북도 청주시 흥덕구 봉명1동,12624,5622,6402,6222
4311375600,43113756,3301264,충청북도 청주시 흥덕구 봉명2.송정동,27564,10502,14023,13541
4311376000,43113760,3301265,충청북도 청주시 흥덕구 강서제1동,20481,8096,10366,10115
4311377000,43113770,3301266,충청북도 청주시 흥덕구 강서제2동,4165,2096,2147,2018
4311378000,43113780,3301259,충청북도 청주시 흥덕구 성화.개신.죽림동,38434,14030,19153,19281
4313000000,43130000,#N/A,충청북도 충주시 ,206241,78374,103975,102266
4313025000,43130250,3302011,충청북도 충주시 주덕읍,6195,2505,3183,3012
4313031000,43130310,3302031,충청북도 충주시 살미면,2243,960,1148,1095
4313032500,43130325,3302032,충청북도 충주시 수안보면,3483,1512,1793,1690
4313033000,43130330,3302033,충청북도 충주시 이류면,5132,2370,2735,2397
4313035000,43130350,3302034,충청북도 충주시 신니면,3860,1537,1989,1871
4313036000,43130360,3302035,충청북도 충주시 노은면,2618,1146,1311,1307
4313037000,43130370,3302036,충청북도 충주시 앙성면,4684,2037,2329,2355
4313038000,43130380,3302037,충청북도 충주시 가금면,2888,1180,1487,1401
4313039000,43130390,3302038,충청북도 충주시 금가면,4322,1662,2264,2058
4313040000,43130400,3302039,충청북도 충주시 동량면,4298,1750,2196,2102
4313041000,43130410,3302040,충청북도 충주시 산척면,2891,1189,1506,1385
4313042000,43130420,3302041,충청북도 충주시 엄정면,3710,1573,1861,1849
4313043000,43130430,3302042,충청북도 충주시 소태면,1984,850,1017,967
4313051500,43130515,3302051,충청북도 충주시 성내.충인동,3418,1520,1700,1718
4313053500,43130535,3302053,충청북도 충주시 교현.안림동,22253,8076,11257,10996
4313054000,43130540,3302054,충청북도 충주시 교현2동,10003,3885,5047,4956
4313055000,43130550,3302055,충청북도 충주시 용산동,15501,5527,7783,7718
4313056000,43130560,3302056,충청북도 충주시 지현동,5845,2311,2971,2874
4313057100,43130571,3302057,충청북도 충주시 문화동,12592,4742,6339,6253
4313058000,43130580,3302058,충청북도 충주시 호암.직동,10473,3791,5227,5246
4313060500,43130605,3302060,충청북도 충주시 달천동,4702,2096,2503,2199
4313061000,43130610,3302061,충청북도 충주시 봉방동,8796,3533,4480,4316
4313062500,43130625,3302062,충청북도 충주시 칠금.금릉동,18318,6003,9079,9239
4313063000,43130630,3302063,충청북도 충주시 연수동,38885,14025,19092,19793
4313064000,43130640,3302064,충청북도 충주시 목행.용탄동,7147,2594,3678,3469
4315000000,43150000,#N/A,충청북도 제천시 ,135841,53228,68416,67425
4315025000,43150250,3303011,충청북도 제천시 봉양읍,7827,3341,3999,3828
4315031000,43150310,3303031,충청북도 제천시 금성면,2249,940,1158,1091
4315032000,43150320,3303032,충청북도 제천시 청풍면,1287,643,668,619
4315033000,43150330,3303033,충청북도 제천시 수산면,2120,1031,1099,1021
4315034000,43150340,3303034,충청북도 제천시 덕산면,2429,1131,1228,1201
4315035000,43150350,3303035,충청북도 제천시 한수면,804,335,421,383
4315036000,43150360,3303036,충청북도 제천시 백운면,3311,1424,1685,1626
4315038000,43150380,3303037,충청북도 제천시 송학면,5456,2316,2904,2552
4315051000,43150510,3303051,충청북도 제천시 교동,18582,6540,9314,9268
4315051500,43150515,3303063,충청북도 제천시 고암.모산동,9136,3328,4536,4600
4315052500,43150525,3303064,충청북도 제천시 중앙.의림.명동,7648,3145,3836,3812
4315053500,43150535,3303065,충청북도 제천시 남천.동현동,7012,2695,3486,3526
4315054500,43150545,3303066,충청북도 제천시 서부.영천동,7308,3175,3734,3574
4315056000,43150560,3303056,충청북도 제천시 용두동,17055,6513,8416,8639
4315057500,43150575,3303067,충청북도 제천시 신백.두학동,14424,5144,7290,7134
4315059000,43150590,3303059,충청북도 제천시 청전동,20962,8118,10458,10504
4315060500,43150605,3303060,충청북도 제천시 화산동,8231,3409,4184,4047
4371000000,43710000,#N/A,충청북도 청원군 ,147680,57919,75815,71865
4371025000,43710250,3331011,충청북도 청원군 내수읍,23089,8811,11749,11340
4371025300,43710253,3331012,충청북도 청원군 오창읍,38740,14468,19782,18958
4371031000,43710310,3331031,충청북도 청원군 낭성면,2535,1138,1314,1221
4371032000,43710320,3331032,충청북도 청원군 미원면,6019,2677,3090,2929
4371033000,43710330,3331033,충청북도 청원군 가덕면,4676,1927,2439,2237
4371034000,43710340,3331034,충청북도 청원군 남일면,8166,2968,4213,3953
4371035000,43710350,3331035,충청북도 청원군 남이면,7288,3016,3806,3482
4371036000,43710360,3331036,충청북도 청원군 문의면,5189,2046,2660,2529
4371037000,43710370,3331037,충청북도 청원군 현도면,4551,1990,2345,2206
4371038000,43710380,3331038,충청북도 청원군 부용면,7589,2996,3937,3652
4371039000,43710390,3331039,충청북도 청원군 강내면,11041,4348,5601,5440
4371040000,43710400,3331040,충청북도 청원군 강외면,11648,4774,5917,5731
4371041000,43710410,3331041,충청북도 청원군 옥산면,11105,4253,5790,5315
4371043000,43710430,3331043,충청북도 청원군 북이면,6044,2507,3172,2872
4372000000,43720000,#N/A,충청북도 보은군 ,35104,14916,17576,17528
4372025000,43720250,3332011,충청북도 보은군 보은읍,15370,6006,7704,7666
4372031500,43720315,3332031,충청북도 보은군 속리산면,2243,1030,1163,1080
4372032500,43720325,3332032,충청북도 보은군 장안면,1407,609,699,708
4372033000,43720330,3332033,충청북도 보은군 마로면,2771,1233,1353,1418
4372034000,43720340,3332034,충청북도 보은군 탄부면,2090,957,1030,1060
4372035000,43720350,3332035,충청북도 보은군 삼승면,2708,1193,1361,1347
4372036000,43720360,3332036,충청북도 보은군 수한면,1998,862,1023,975
4372037000,43720370,3332037,충청북도 보은군 회남면,738,376,370,368
4372038500,43720385,3332038,충청북도 보은군 회인면,2007,960,1002,1005
4372039000,43720390,3332039,충청북도 보은군 내북면,1900,879,921,979
4372040000,43720400,3332040,충청북도 보은군 산외면,1872,811,950,922
4373000000,43730000,#N/A,충청북도 옥천군 ,54649,21464,27570,27079
4373025000,43730250,3333011,충청북도 옥천군 옥천읍,30545,10609,15446,15099
4373031000,43730310,3333031,충청북도 옥천군 동이면,3403,1505,1744,1659
4373032000,43730320,3333032,충청북도 옥천군 안남면,1565,721,750,815
4373033000,43730330,3333033,충청북도 옥천군 안내면,2166,1049,1104,1062
4373034000,43730340,3333034,충청북도 옥천군 청성면,2639,1329,1332,1307
4373035000,43730350,3333035,충청북도 옥천군 청산면,3748,1720,1796,1952
4373036000,43730360,3333036,충청북도 옥천군 이원면,4912,2117,2505,2407
4373037000,43730370,3333037,충청북도 옥천군 군서면,2509,1070,1298,1211
4373038000,43730380,3333038,충청북도 옥천군 군북면,3162,1344,1595,1567
4374000000,43740000,#N/A,충청북도 영동군 ,50214,20675,25083,25131
4374025000,43740250,3334011,충청북도 영동군 영동읍,21035,7978,10617,10418
4374031000,43740310,3334031,충청북도 영동군 용산면,3718,1578,1907,1811
4374032000,43740320,3334032,충청북도 영동군 황간면,4786,1983,2360,2426
4374033500,43740335,3334033,충청북도 영동군 추풍령면,2622,1071,1283,1339
4374034000,43740340,3334034,충청북도 영동군 매곡면,2123,965,1037,1086
4374035000,43740350,3334035,충청북도 영동군 상촌면,2424,1139,1193,1231
4374036000,43740360,3334036,충청북도 영동군 양강면,3608,1475,1774,1834
4374037000,43740370,3334037,충청북도 영동군 용화면,990,469,481,509
4374038000,43740380,3334038,충청북도 영동군 학산면,3139,1432,1542,1597
4374039000,43740390,3334039,충청북도 영동군 양산면,2128,974,1059,1069
4374040000,43740400,3334040,충청북도 영동군 심천면,3641,1611,1830,1811
4374500000,43745000,#N/A,충청북도 증평군 ,32081,12440,16272,15809
4374525000,43745250,3339014,충청북도 증평군 증평읍,29631,11432,15012,14619
4374531000,43745310,3339031,충청북도 증평군 도안면,2450,1008,1260,1190
4375000000,43750000,#N/A,충청북도 진천군 ,60714,24584,31300,29414
4375025000,43750250,3335011,충청북도 진천군 진천읍,26750,10166,13580,13170
4375031000,43750310,3335031,충청북도 진천군 덕산면,6315,2682,3343,2972
4375032000,43750320,3335032,충청북도 진천군 초평면,3765,1581,1947,1818
4375033000,43750330,3335033,충청북도 진천군 문백면,4051,1741,2105,1946
4375034000,43750340,3335034,충청북도 진천군 백곡면,2240,1076,1131,1109
4375035000,43750350,3335035,충청북도 진천군 이월면,7977,3376,4164,3813
4375037000,43750370,3335036,충청북도 진천군 광혜원면,9616,3962,5030,4586
4376000000,43760000,#N/A,충청북도 괴산군 ,36596,16394,18436,18160
4376025000,43760250,3336011,충청북도 괴산군 괴산읍,8931,3648,4446,4485
4376031000,43760310,3336031,충청북도 괴산군 감물면,1937,871,969,968
4376032000,43760320,3336032,충청북도 괴산군 장연면,2071,929,1033,1038
4376033000,43760330,3336033,충청북도 괴산군 연풍면,2588,1153,1319,1269
4376034000,43760340,3336034,충청북도 괴산군 칠성면,2728,1236,1364,1364
4376035000,43760350,3336035,충청북도 괴산군 문광면,2020,989,999,1021
4376036000,43760360,3336036,충청북도 괴산군 청천면,4961,2454,2469,2492
4376037000,43760370,3336037,충청북도 괴산군 청안면,3409,1533,1784,1625
4376039000,43760390,3336038,충청북도 괴산군 사리면,3048,1330,1562,1486
4376040000,43760400,3336039,충청북도 괴산군 소수면,1803,848,923,880
4376041000,43760410,3336040,충청북도 괴산군 불정면,3100,1403,1568,1532
4377000000,43770000,#N/A,충청북도 음성군 ,89594,35617,46616,42978
4377025000,43770250,3337011,충청북도 음성군 음성읍,18002,6974,9221,8781
4377025300,43770253,3337012,충청북도 음성군 금왕읍,21014,8275,10838,10176
4377031000,43770310,3337031,충청북도 음성군 소이면,3420,1535,1790,1630
4377032000,43770320,3337032,충청북도 음성군 원남면,3280,1456,1692,1588
4377033000,43770330,3337033,충청북도 음성군 맹동면,4952,1246,2756,2196
4377034000,43770340,3337034,충청북도 음성군 대소면,16039,6546,8310,7729
4377035000,43770350,3337035,충청북도 음성군 삼성면,7626,3293,4109,3517
4377036000,43770360,3337036,충청북도 음성군 생극면,4895,2062,2615,2280
4377037000,43770370,3337037,충청북도 음성군 감곡면,10366,4230,5285,5081
4380000000,43800000,#N/A,충청북도 단양군 ,32042,13360,16098,15944
4380025000,43800250,3338011,충청북도 단양군 단양읍,11529,4405,5801,5728
4380025300,43800253,3338012,충청북도 단양군 매포읍,6986,2783,3572,3414
4380031000,43800310,3338032,충청북도 단양군 대강면,2602,1213,1274,1328
4380032000,43800320,3338033,충청북도 단양군 가곡면,2080,913,1059,1021
4380033000,43800330,3338034,충청북도 단양군 영춘면,3571,1553,1718,1853
4380034000,43800340,3338035,충청북도 단양군 어상천면,1912,887,963,949
4380035000,43800350,3338036,충청북도 단양군 적성면,1506,743,768,738
4380036000,43800360,3338031,충청북도 단양군 단성면,1856,863,943,913
4400000000,44000000,#N/A,충청남도  ,2014066,809060,1017957,996109
4413000000,44130000,#N/A,충청남도 천안시 ,536280,208400,271158,265122
4413100000,44131000,#N/A,충청남도 천안시 동남구 ,235196,94498,118640,116556
4413125000,44131250,3401111,충청남도 천안시 동남구 목천읍,27216,10519,13828,13388
4413131000,44131310,3401131,충청남도 천안시 동남구 풍세면,5052,2092,2627,2425
4413132000,44131320,3401132,충청남도 천안시 동남구 광덕면,4531,2017,2304,2227
4413133000,44131330,3401133,충청남도 천안시 동남구 북면,5417,2356,2804,2613
4413134000,44131340,3401134,충청남도 천안시 동남구 성남면,4146,1779,2138,2008
4413135000,44131350,3401135,충청남도 천안시 동남구 수신면,2804,1265,1480,1324
4413136000,44131360,3401136,충청남도 천안시 동남구 병천면,6581,2963,3390,3191
4413137000,44131370,3401137,충청남도 천안시 동남구 동면,2677,1146,1380,1297
4413151000,44131510,3401151,충청남도 천안시 동남구 중앙동,6955,3346,3594,3361
4413152000,44131520,3401152,충청남도 천안시 동남구 문성동,5872,2954,2984,2888
4413153000,44131530,3401153,충청남도 천안시 동남구 원성1동,11339,4737,5918,5421
4413154000,44131540,3401154,충청남도 천안시 동남구 원성2동,13684,5597,6848,6836
4413155000,44131550,3401155,충청남도 천안시 동남구 봉명동,22384,9688,11141,11243
4413156000,44131560,3401156,충청남도 천안시 동남구 일봉동,17663,6498,8891,8772
4413157000,44131570,3401157,충청남도 천안시 동남구 신방동,35596,12708,17689,17907
4413158000,44131580,3401158,충청남도 천안시 동남구 청룡동,30775,10460,15323,15452
4413159000,44131590,3401159,충청남도 천안시 동남구 신안동,32504,14373,16301,16203
4413300000,44133000,#N/A,충청남도 천안시 서북구 ,301084,113902,152518,148566
4413325000,44133250,3401211,충청남도 천안시 서북구 성환읍,29455,11488,15113,14342
4413325300,44133253,3401212,충청남도 천안시 서북구 성거읍,21862,8553,11286,10576
4413325600,44133256,3401213,충청남도 천안시 서북구 직산읍,23786,9593,12708,11078
4413331000,44133310,3401231,충청남도 천안시 서북구 입장면,11687,4678,6118,5569
4413351000,44133510,3401251,충청남도 천안시 서북구 성정1동,19642,8562,9854,9788
4413352000,44133520,3401252,충청남도 천안시 서북구 성정2동,21457,9835,10727,10730
4413353000,44133530,3401253,충청남도 천안시 서북구 쌍용1동,15967,5467,7846,8121
4413354000,44133540,3401254,충청남도 천안시 서북구 쌍용2동,44281,14814,21976,22305
4413355000,44133550,3401255,충청남도 천안시 서북구 쌍용3동,20336,7563,10004,10332
4413356000,44133560,3401256,충청남도 천안시 서북구 백석동,41049,13037,20485,20564
4415000000,44150000,#N/A,충청남도 공주시 ,125520,49882,63336,62184
4415025000,44150250,3402011,충청남도 공주시 유구읍,9522,3811,4939,4583
4415031000,44150310,3402031,충청남도 공주시 이인면,4175,1737,2119,2056
4415032000,44150320,3402032,충청남도 공주시 탄천면,3804,1655,1953,1851
4415033000,44150330,3402033,충청남도 공주시 계룡면,6864,3052,3613,3251
4415034000,44150340,3402034,충청남도 공주시 반포면,5903,2502,3064,2839
4415035000,44150350,3402035,충청남도 공주시 장기면,5330,2178,2791,2539
4415036000,44150360,3402036,충청남도 공주시 의당면,7131,2875,3645,3486
4415037000,44150370,3402037,충청남도 공주시 정안면,5697,2313,2911,2786
4415038000,44150380,3402038,충청남도 공주시 우성면,6638,2744,3412,3226
4415039000,44150390,3402039,충청남도 공주시 사곡면,3509,1519,1741,1768
4415040000,44150400,3402040,충청남도 공주시 신풍면,3757,1539,1774,1983
4415051000,44150510,3402051,충청남도 공주시 중학동,7239,3049,3628,3611
4415053000,44150530,#N/A,충청남도 공주시 산성동,0,0,0,0
4415054000,44150540,3402058,충청남도 공주시 웅진동,10594,4097,5261,5333
4415055000,44150550,3402055,충청남도 공주시 금학동,4963,1982,2559,2404
4415056000,44150560,3402056,충청남도 공주시 옥룡동,11680,4642,5789,5891
4415057000,44150570,3402057,충청남도 공주시 신관동,28714,10187,14137,14577
4418000000,44180000,#N/A,충청남도 보령시 ,106956,43578,54114,52842
4418025000,44180250,3403011,충청남도 보령시 웅천읍,7701,3376,3905,3796
4418031000,44180310,3403031,충청남도 보령시 주포면,1903,917,1015,888
4418032000,44180320,3403033,충청남도 보령시 오천면,6023,2684,3131,2892
4418033000,44180330,3403034,충청남도 보령시 천북면,4323,1859,2259,2064
4418034000,44180340,3403035,충청남도 보령시 청소면,3354,1473,1625,1729
4418035000,44180350,3403036,충청남도 보령시 청라면,4675,2016,2396,2279
4418036000,44180360,3403037,충청남도 보령시 남포면,6026,2566,3019,3007
4418038000,44180380,3403038,충청남도 보령시 주산면,3171,1456,1565,1606
4418039000,44180390,3403039,충청남도 보령시 미산면,2126,982,1076,1050
4418040000,44180400,3403040,충청남도 보령시 성주면,3047,1248,1549,1498
4418041000,44180410,3403032,충청남도 보령시 주교면,5973,2411,3162,2811
4418051500,44180515,3403051,충청남도 보령시 대천1동,17408,6382,8717,8691
4418052500,44180525,3403052,충청남도 보령시 대천2동,7567,2915,3799,3768
4418053500,44180535,3403053,충청남도 보령시 대천3동,11133,4370,5584,5549
4418054500,44180545,3403054,충청남도 보령시 대천4동,14639,5473,7206,7433
4418056500,44180565,3403056,충청남도 보령시 대천5동,7887,3450,4106,3781
4420000000,44200000,#N/A,충청남도 아산시 ,238405,98728,121626,116779
4420025000,44200250,3404011,충청남도 아산시 염치읍,8025,3353,4223,3802
4420031000,44200310,3404031,충청남도 아산시 송악면,3681,1558,1900,1781
4420032000,44200320,3404032,충청남도 아산시 배방면,41253,16913,20777,20476
4420033000,44200330,3404033,충청남도 아산시 탕정면,12272,7999,6070,6202
4420035000,44200350,3404034,충청남도 아산시 음봉면,16669,7581,9066,7603
4420036000,44200360,3404035,충청남도 아산시 둔포면,10669,4325,5607,5062
4420037000,44200370,3404036,충청남도 아산시 영인면,6861,2698,3587,3274
4420038000,44200380,3404037,충청남도 아산시 인주면,7535,3391,4124,3411
4420039000,44200390,3404038,충청남도 아산시 선장면,4221,1809,2101,2120
4420040000,44200400,3404039,충청남도 아산시 도고면,5385,2251,2768,2617
4420041000,44200410,3404040,충청남도 아산시 신창면,16750,6913,8750,8000
4420057000,44200570,3404051,충청남도 아산시 온양1동,7448,3239,3742,3706
4420058000,44200580,3404052,충청남도 아산시 온양2동,9509,3866,4753,4756
4420059000,44200590,3404053,충청남도 아산시 온양3동,25216,9386,12561,12655
4420060000,44200600,3404054,충청남도 아산시 온양4동,20928,7819,10667,10261
4420061000,44200610,3404055,충청남도 아산시 온양5동,16077,5548,8125,7952
4420062000,44200620,3404056,충청남도 아산시 온양6동,25906,10079,12805,13101
4421000000,44210000,#N/A,충청남도 서산시 ,156402,61081,79566,76836
4421025000,44210250,3405011,충청남도 서산시 대산읍,16526,6254,8728,7798
4421031000,44210310,3405031,충청남도 서산시 인지면,7579,2964,3855,3724
4421032000,44210320,3405032,충청남도 서산시 부석면,6260,2624,3198,3062
4421033000,44210330,3405033,충청남도 서산시 팔봉면,3511,1538,1774,1737
4421034000,44210340,3405034,충청남도 서산시 지곡면,5558,2341,2855,2703
4421036000,44210360,3405035,충청남도 서산시 성연면,3071,1248,1563,1508
4421037000,44210370,3405036,충청남도 서산시 음암면,10133,3936,5254,4879
4421038000,44210380,3405037,충청남도 서산시 운산면,5809,2555,2959,2850
4421039000,44210390,3405038,충청남도 서산시 해미면,8480,3765,4432,4048
4421040000,44210400,3405039,충청남도 서산시 고북면,8424,3253,4284,4140
4421051000,44210510,3405051,충청남도 서산시 부춘동,19040,7373,9584,9456
4421052500,44210525,3405052,충청남도 서산시 동문1동,16286,6114,8329,7957
4421053500,44210535,3405053,충청남도 서산시 동문2동,10692,4336,5250,5442
4421054000,44210540,3405054,충청남도 서산시 수석동,15044,5745,7388,7656
4421055000,44210550,3405055,충청남도 서산시 석남동,19989,7035,10113,9876
4423000000,44230000,#N/A,충청남도 논산시 ,128140,51875,64312,63828
4423025000,44230250,3406011,충청남도 논산시 강경읍,11848,4999,5816,6032
4423025300,44230253,3406012,충청남도 논산시 연무읍,17191,6967,8704,8487
4423031000,44230310,3406031,충청남도 논산시 성동면,5640,2344,2899,2741
4423032000,44230320,3406032,충청남도 논산시 광석면,5517,2315,2813,2704
4423033000,44230330,3406033,충청남도 논산시 노성면,4163,1724,2107,2056
4423034000,44230340,3406034,충청남도 논산시 상월면,4140,1783,2118,2022
4423035000,44230350,3406035,충청남도 논산시 부적면,4484,1940,2269,2215
4423036000,44230360,3406036,충청남도 논산시 연산면,7199,3124,3722,3477
4423038000,44230380,3406037,충청남도 논산시 벌곡면,2937,1420,1516,1421
4423039000,44230390,3406038,충청남도 논산시 양촌면,6447,2690,3234,3213
4423040000,44230400,3406039,충청남도 논산시 가야곡면,4421,1956,2236,2185
4423041000,44230410,3406040,충청남도 논산시 은진면,5059,2274,2573,2486
4423042000,44230420,3406041,충청남도 논산시 채운면,3250,1351,1637,1613
4423051000,44230510,3406051,충청남도 논산시 취암동,28358,10503,14072,14286
4423052000,44230520,3406052,충청남도 논산시 부창동,17486,6485,8596,8890
4425000000,44250000,#N/A,충청남도 계룡시 ,41154,13679,20274,20880
4425031000,44250310,3407031,충청남도 계룡시 두마면,5754,2138,2823,2931
4425031500,44250315,3407033,충청남도 계룡시 엄사면,18481,6427,9029,9452
4425032000,44250320,3407032,충청남도 계룡시 남선면,8447,2342,4242,4205
4425051000,44250510,3407051,충청남도 계룡시 금암동,8472,2772,4180,4292
4471000000,44710000,#N/A,충청남도 금산군 ,56735,23910,28854,27881
4471025000,44710250,3431011,충청남도 금산군 금산읍,23313,8789,11799,11514
4471031000,44710310,3431031,충청남도 금산군 금성면,4347,1960,2200,2147
4471032000,44710320,3431032,충청남도 금산군 제원면,3302,1467,1700,1602
4471033000,44710330,3431033,충청남도 금산군 부리면,3201,1478,1600,1601
4471034000,44710340,3431034,충청남도 금산군 군북면,2781,1215,1412,1369
4471035000,44710350,3431035,충청남도 금산군 남일면,2958,1337,1475,1483
4471036000,44710360,3431036,충청남도 금산군 남이면,2303,1054,1179,1124
4471037000,44710370,3431037,충청남도 금산군 진산면,3696,1796,1826,1870
4471038000,44710380,3431038,충청남도 금산군 복수면,3853,1830,2042,1811
4471039000,44710390,3431039,충청남도 금산군 추부면,6981,2984,3621,3360
4473000000,44730000,#N/A,충청남도 연기군 ,78781,32170,40301,38480
4473025000,44730250,3432011,충청남도 연기군 조치원읍,37215,14317,18927,18288
4473031000,44730310,3432031,충청남도 연기군 동면,4330,2005,2210,2120
4473032000,44730320,3432032,충청남도 연기군 서면,8323,3353,4286,4037
4473033000,44730330,3432033,충청남도 연기군 남면,4262,1744,2216,2046
4473034000,44730340,3432034,충청남도 연기군 금남면,9865,4195,5045,4820
4473035000,44730350,3432035,충청남도 연기군 전의면,7234,3157,3678,3556
4473036000,44730360,3432036,충청남도 연기군 전동면,4278,2068,2259,2019
4473037000,44730370,3432037,충청남도 연기군 소정면,3274,1331,1680,1594
4476000000,44760000,#N/A,충청남도 부여군 ,76931,31584,38471,38460
4476025000,44760250,3433011,충청남도 부여군 부여읍,25043,9500,12512,12531
4476031000,44760310,3433031,충청남도 부여군 규암면,11022,4265,5570,5452
4476032000,44760320,3433032,충청남도 부여군 은산면,4505,1826,2231,2274
4476033000,44760330,3433033,충청남도 부여군 외산면,2967,1256,1486,1481
4476034000,44760340,3433034,충청남도 부여군 내산면,1914,825,954,960
4476035000,44760350,3433035,충청남도 부여군 구룡면,2817,1239,1393,1424
4476036000,44760360,3433036,충청남도 부여군 홍산면,3542,1529,1749,1793
4476037000,44760370,3433037,충청남도 부여군 옥산면,1669,790,798,871
4476038000,44760380,3433038,충청남도 부여군 남면,2293,1051,1086,1207
4476039000,44760390,3433039,충청남도 부여군 충화면,1434,671,702,732
4476040000,44760400,3433040,충청남도 부여군 양화면,2210,1042,1077,1133
4476041000,44760410,3433041,충청남도 부여군 임천면,3485,1631,1724,1761
4476042000,44760420,3433042,충청남도 부여군 장암면,3334,1445,1699,1635
4476043000,44760430,3433043,충청남도 부여군 세도면,4147,1834,2133,2014
4476044000,44760440,3433044,충청남도 부여군 석성면,3725,1471,1945,1780
4476045000,44760450,3433045,충청남도 부여군 초촌면,2824,1209,1412,1412
4477000000,44770000,#N/A,충청남도 서천군 ,60667,25810,30043,30624
4477025000,44770250,3434011,충청남도 서천군 장항읍,13934,5793,6987,6947
4477025300,44770253,3434012,충청남도 서천군 서천읍,13396,5130,6672,6724
4477031000,44770310,3434031,충청남도 서천군 마서면,6603,2810,3269,3334
4477032000,44770320,3434032,충청남도 서천군 화양면,2973,1345,1451,1522
4477033000,44770330,3434033,충청남도 서천군 기산면,2085,964,1011,1074
4477034000,44770340,3434034,충청남도 서천군 한산면,3253,1483,1603,1650
4477035000,44770350,3434035,충청남도 서천군 마산면,1735,785,832,903
4477036000,44770360,3434036,충청남도 서천군 시초면,1497,746,724,773
4477037000,44770370,3434037,충청남도 서천군 문산면,1519,726,739,780
4477038000,44770380,3434038,충청남도 서천군 판교면,2481,1173,1198,1283
4477039000,44770390,3434039,충청남도 서천군 종천면,2482,1102,1182,1300
4477040000,44770400,3434040,충청남도 서천군 비인면,3686,1656,1812,1874
4477041000,44770410,3434041,충청남도 서천군 서면,5023,2097,2563,2460
4479000000,44790000,#N/A,충청남도 청양군 ,33201,13940,16751,16450
4479025000,44790250,3435011,충청남도 청양군 청양읍,10150,3944,5127,5023
4479031000,44790310,3435031,충청남도 청양군 운곡면,2323,1031,1155,1168
4479032000,44790320,3435032,충청남도 청양군 대치면,2354,1018,1192,1162
4479033000,44790330,3435033,충청남도 청양군 정산면,3908,1595,2013,1895
4479034000,44790340,3435034,충청남도 청양군 목면,1691,735,869,822
4479035000,44790350,3435035,충청남도 청양군 청남면,2154,965,1064,1090
4479036000,44790360,3435036,충청남도 청양군 장평면,2716,1157,1386,1330
4479037000,44790370,3435037,충청남도 청양군 남양면,3044,1367,1516,1528
4479038000,44790380,3435038,충청남도 청양군 화성면,2461,1089,1221,1240
4479039000,44790390,3435039,충청남도 청양군 비봉면,2400,1039,1208,1192
4480000000,44800000,#N/A,충청남도 홍성군 ,88351,35388,43865,44486
4480025000,44800250,3436011,충청남도 홍성군 홍성읍,41084,15551,20261,20823
4480025300,44800253,3436012,충청남도 홍성군 광천읍,11518,4775,5773,5745
4480031000,44800310,3436031,충청남도 홍성군 홍북면,5247,2104,2622,2625
4480032000,44800320,3436032,충청남도 홍성군 금마면,4055,1749,2061,1994
4480033000,44800330,3436033,충청남도 홍성군 홍동면,4122,1623,2098,2024
4480034000,44800340,3436034,충청남도 홍성군 장곡면,3681,1644,1810,1871
4480035000,44800350,3436035,충청남도 홍성군 은하면,2959,1225,1484,1475
4480036000,44800360,3436036,충청남도 홍성군 결성면,2740,1194,1357,1383
4480037000,44800370,3436037,충청남도 홍성군 서부면,3991,1694,1892,2099
4480038000,44800380,3436038,충청남도 홍성군 갈산면,4443,1865,2209,2234
4480039000,44800390,3436039,충청남도 홍성군 구항면,4511,1964,2298,2213
4481000000,44810000,#N/A,충청남도 예산군 ,88440,35935,44418,44022
4481025000,44810250,3437011,충청남도 예산군 예산읍,37155,14568,18552,18603
4481025300,44810253,3437012,충청남도 예산군 삽교읍,9005,3634,4504,4501
4481031000,44810310,3437031,충청남도 예산군 대술면,3153,1350,1614,1539
4481032000,44810320,3437032,충청남도 예산군 신양면,3743,1570,1850,1893
4481033000,44810330,3437033,충청남도 예산군 광시면,3807,1647,1872,1935
4481034000,44810340,3437034,충청남도 예산군 대흥면,2215,952,1098,1117
4481035000,44810350,3437035,충청남도 예산군 응봉면,3057,1257,1569,1488
4481036000,44810360,3437036,충청남도 예산군 덕산면,6994,2952,3419,3575
4481037000,44810370,3437037,충청남도 예산군 봉산면,2991,1285,1511,1480
4481038000,44810380,3437038,충청남도 예산군 고덕면,5782,2343,2949,2833
4481039000,44810390,3437039,충청남도 예산군 신암면,4609,1993,2372,2237
4481040000,44810400,3437040,충청남도 예산군 오가면,5929,2384,3108,2821
4482500000,44825000,#N/A,충청남도 태안군 ,63534,27149,31884,31650
4482525000,44825250,3438011,충청남도 태안군 태안읍,26500,10368,13343,13157
4482525300,44825253,3438012,충청남도 태안군 안면읍,9789,4526,4896,4893
4482531000,44825310,3438031,충청남도 태안군 고남면,2778,1201,1353,1425
4482532000,44825320,3438032,충청남도 태안군 남면,4643,2067,2319,2324
4482533000,44825330,3438033,충청남도 태안군 근흥면,6149,2884,3148,3001
4482534000,44825340,3438034,충청남도 태안군 소원면,6279,2770,3107,3172
4482535000,44825350,3438035,충청남도 태안군 원북면,4937,2213,2476,2461
4482536000,44825360,3438036,충청남도 태안군 이원면,2459,1120,1242,1217
4483000000,44830000,#N/A,충청남도 당진군 ,134569,55951,68984,65585
4483025000,44830250,3439011,충청남도 당진군 당진읍,41887,16317,20991,20896
4483025300,44830253,3439012,충청남도 당진군 합덕읍,11291,4709,5805,5486
4483031000,44830310,3439031,충청남도 당진군 고대면,6408,2737,3308,3100
4483032000,44830320,3439032,충청남도 당진군 석문면,7975,3546,4066,3909
4483033000,44830330,3439033,충청남도 당진군 대호지면,2974,1264,1504,1470
4483034000,44830340,3439034,충청남도 당진군 정미면,3897,1790,1947,1950
4483035000,44830350,3439035,충청남도 당진군 면천면,4045,1670,2058,1987
4483036000,44830360,3439036,충청남도 당진군 순성면,6442,2566,3279,3163
4483037000,44830370,3439037,충청남도 당진군 우강면,6709,2644,3359,3350
4483038000,44830380,3439038,충청남도 당진군 신평면,13398,5272,6849,6549
4483039000,44830390,3439039,충청남도 당진군 송악면,20194,9341,10769,9425
4483040000,44830400,3439040,충청남도 당진군 송산면,9349,4095,5049,4300
4500000000,45000000,#N/A,전라북도  ,1855363,708828,924335,931028
4511000000,45110000,#N/A,전라북도 전주시 ,631856,222902,311616,320240
4511100000,45111000,#N/A,전라북도 전주시 완산구 ,352400,122925,172417,179983
4511151000,45111510,3501174,전라북도 전주시 완산구 중앙동,9768,4567,4916,4852
4511153000,45111530,3501175,전라북도 전주시 완산구 풍남동,8623,3937,4366,4257
4511160500,45111605,3501176,전라북도 전주시 완산구 노송동,17047,7020,8497,8550
4511163500,45111635,3501177,전라북도 전주시 완산구 완산동,7379,3214,3768,3611
4511165000,45111650,3501160,전라북도 전주시 완산구 동서학동,9373,3488,4765,4608
4511166000,45111660,3501161,전라북도 전주시 완산구 서서학동,12726,4755,6290,6436
4511167100,45111671,3501162,전라북도 전주시 완산구 중화산1동,14633,5028,7178,7455
4511167200,45111672,3501163,전라북도 전주시 완산구 중화산2동,19729,6844,9748,9981
4511168000,45111680,3501166,전라북도 전주시 완산구 서신동,47863,15793,23424,24439
4511169100,45111691,3501164,전라북도 전주시 완산구 평화1동,15187,6230,7230,7957
4511169200,45111692,3501165,전라북도 전주시 완산구 평화2동,46022,14891,22242,23780
4511170100,45111701,3501167,전라북도 전주시 완산구 삼천1동,16168,5547,7758,8410
4511170200,45111702,3501168,전라북도 전주시 완산구 삼천2동,19975,6512,9648,10327
4511170300,45111703,3501169,전라북도 전주시 완산구 삼천3동,25794,7991,12585,13209
4511171100,45111711,3501170,전라북도 전주시 완산구 효자1동,15331,5457,7370,7961
4511171200,45111712,3501171,전라북도 전주시 완산구 효자2동,14406,5095,7032,7374
4511171300,45111713,3501172,전라북도 전주시 완산구 효자3동,18648,5678,9031,9617
4511171400,45111714,3501173,전라북도 전주시 완산구 효자4동,33728,10878,16569,17159
4511300000,45113000,#N/A,전라북도 전주시 덕진구 ,279456,99977,139199,140257
4511352500,45113525,3501269,전라북도 전주시 덕진구 진북동,19296,7424,9620,9676
4511354000,45113540,3501254,전라북도 전주시 덕진구 인후1동,20654,6987,10090,10564
4511355000,45113550,3501255,전라북도 전주시 덕진구 인후2동,14042,5647,7053,6989
4511356000,45113560,3501256,전라북도 전주시 덕진구 인후3동,35687,12456,17361,18326
4511357000,45113570,3501257,전라북도 전주시 덕진구 덕진동,14013,5921,7184,6829
4511358000,45113580,3501258,전라북도 전주시 덕진구 금암1동,8441,4106,4319,4122
4511359000,45113590,3501259,전라북도 전주시 덕진구 금암2동,12617,5128,6356,6261
4511360000,45113600,3501260,전라북도 전주시 덕진구 팔복동,11795,4819,6291,5504
4511361100,45113611,3501261,전라북도 전주시 덕진구 우아1동,13438,5224,6710,6728
4511361200,45113612,3501262,전라북도 전주시 덕진구 우아2동,13770,5346,6883,6887
4511362000,45113620,3501263,전라북도 전주시 덕진구 호성동,24223,7533,11805,12418
4511364100,45113641,3501265,전라북도 전주시 덕진구 송천1동,34577,10510,17028,17549
4511364200,45113642,3501266,전라북도 전주시 덕진구 송천2동,28095,8651,13923,14172
4511365000,45113650,3501267,전라북도 전주시 덕진구 조촌동,11410,4305,5772,5638
4511366000,45113660,3501268,전라북도 전주시 덕진구 동산동,17398,5920,8804,8594
4513000000,45130000,#N/A,전라북도 군산시 ,262673,98638,133212,129461
4513025000,45130250,3502011,전라북도 군산시 옥구읍,4066,1726,2136,1930
4513031000,45130310,3502031,전라북도 군산시 옥산면,3173,1261,1612,1561
4513032000,45130320,3502032,전라북도 군산시 회현면,3843,1570,2014,1829
4513033000,45130330,3502033,전라북도 군산시 임피면,3590,1501,1792,1798
4513034000,45130340,3502034,전라북도 군산시 서수면,3341,1317,1634,1707
4513035000,45130350,3502035,전라북도 군산시 대야면,6923,2861,3549,3374
4513036000,45130360,3502036,전라북도 군산시 개정면,4044,1576,2060,1984
4513037000,45130370,3502037,전라북도 군산시 성산면,3642,1416,1899,1743
4513038000,45130380,3502038,전라북도 군산시 나포면,2910,1248,1491,1419
4513039000,45130390,3502039,전라북도 군산시 옥도면,4481,1733,2452,2029
4513040000,45130400,3502040,전라북도 군산시 옥서면,5678,2152,2960,2718
4513051500,45130515,3502051,전라북도 군산시 해신동,4664,1993,2417,2247
4513053000,45130530,3502053,전라북도 군산시 월명동,9741,4297,4976,4765
4513055000,45130550,3502055,전라북도 군산시 신풍동,9891,3726,4998,4893
4513056000,45130560,3502056,전라북도 군산시 삼학동,8782,3593,4433,4349
4513060500,45130605,3502060,전라북도 군산시 중앙동,4956,2276,2533,2423
4513064000,45130640,3502064,전라북도 군산시 흥남동,11110,4530,5656,5454
4513065000,45130650,3502065,전라북도 군산시 조촌동,14984,5553,7674,7310
4513066000,45130660,3502066,전라북도 군산시 경암동,9636,4000,4906,4730
4513067000,45130670,3502067,전라북도 군산시 구암동,6518,2247,3340,3178
4513068000,45130680,3502068,전라북도 군산시 개정동,3951,1363,2024,1927
4513069000,45130690,3502069,전라북도 군산시 수송동,20688,6711,10324,10364
4513070100,45130701,3502070,전라북도 군산시 나운1동,16999,6025,8481,8518
4513070200,45130702,3502071,전라북도 군산시 나운2동,27232,9075,13296,13936
4513070300,45130703,3502074,전라북도 군산시 나운3동,36523,12781,18382,18141
4513071000,45130710,3502072,전라북도 군산시 소룡동,18353,6685,9462,8891
4513072000,45130720,3502073,전라북도 군산시 미성동,12954,5422,6711,6243
4514000000,45140000,#N/A,전라북도 익산시 ,310248,114306,155072,155176
4514025000,45140250,3503011,전라북도 익산시 함열읍,8132,3078,4105,4027
4514031000,45140310,3503031,전라북도 익산시 오산면,5129,2064,2676,2453
4514032000,45140320,3503032,전라북도 익산시 황등면,9923,3841,5048,4875
4514033000,45140330,3503033,전라북도 익산시 함라면,2820,1163,1435,1385
4514034000,45140340,3503034,전라북도 익산시 웅포면,2012,897,1030,982
4514035000,45140350,3503035,전라북도 익산시 성당면,2666,1102,1360,1306
4514036000,45140360,3503036,전라북도 익산시 용안면,3546,1469,1838,1708
4514037000,45140370,3503037,전라북도 익산시 낭산면,4078,1682,2140,1938
4514038000,45140380,3503038,전라북도 익산시 망성면,4010,1741,2025,1985
4514039000,45140390,3503039,전라북도 익산시 여산면,4122,1747,2146,1976
4514040000,45140400,3503040,전라북도 익산시 금마면,5614,2222,2999,2615
4514041000,45140410,3503041,전라북도 익산시 왕궁면,6507,2894,3294,3213
4514042000,45140420,3503042,전라북도 익산시 춘포면,5856,2446,3023,2833
4514043000,45140430,3503043,전라북도 익산시 삼기면,3363,1315,1724,1639
4514044000,45140440,3503044,전라북도 익산시 용동면,2143,895,1088,1055
4514052000,45140520,3503051,전라북도 익산시 중앙동,5422,2495,2733,2689
4514053000,45140530,3503053,전라북도 익산시 평화동,6793,2865,3407,3386
4514056000,45140560,3503055,전라북도 익산시 인화동,8834,3566,4460,4374
4514057000,45140570,3503057,전라북도 익산시 동산동,25028,9089,12470,12558
4514058000,45140580,3503058,전라북도 익산시 마동,13114,5036,6558,6556
4514059500,45140595,3503059,전라북도 익산시 남중동,15610,6109,7900,7710
4514061000,45140610,3503061,전라북도 익산시 모현동,26556,9105,13052,13504
4514062000,45140620,3503062,전라북도 익산시 송학동,7323,2695,3691,3632
4514064600,45140646,3503066,전라북도 익산시 영등1동,29626,9531,14712,14914
4514064700,45140647,3503071,전라북도 익산시 영등2동,17474,5538,8490,8984
4514065200,45140652,3503072,전라북도 익산시 어양동,25040,8607,12274,12766
4514065600,45140656,3503065,전라북도 익산시 신동,16960,6907,8511,8449
4514067000,45140670,3503069,전라북도 익산시 팔봉동,7691,2706,3917,3774
4514069000,45140690,3503070,전라북도 익산시 삼성동,34856,11501,16966,17890
4518000000,45180000,#N/A,전라북도 정읍시 ,123062,50317,60822,62240
4518025000,45180250,3504011,전라북도 정읍시 신태인읍,7256,3299,3565,3691
4518031000,45180310,3504031,전라북도 정읍시 북면,5587,2313,2799,2788
4518032000,45180320,3504032,전라북도 정읍시 입암면,3753,1674,1879,1874
4518033000,45180330,3504033,전라북도 정읍시 소성면,2729,1290,1374,1355
4518034000,45180340,3504034,전라북도 정읍시 고부면,3678,1664,1837,1841
4518035000,45180350,3504035,전라북도 정읍시 영원면,2337,1135,1170,1167
4518036000,45180360,3504036,전라북도 정읍시 덕천면,2436,1020,1220,1216
4518037000,45180370,3504037,전라북도 정읍시 이평면,2946,1388,1463,1483
4518038000,45180380,3504038,전라북도 정읍시 정우면,3285,1546,1653,1632
4518039000,45180390,3504039,전라북도 정읍시 태인면,4747,2121,2361,2386
4518040000,45180400,3504040,전라북도 정읍시 감곡면,3578,1713,1781,1797
4518041000,45180410,3504041,전라북도 정읍시 옹동면,2180,1040,1083,1097
4518042000,45180420,3504042,전라북도 정읍시 칠보면,2911,1335,1476,1435
4518043000,45180430,3504043,전라북도 정읍시 산내면,1568,745,764,804
4518044000,45180440,3504044,전라북도 정읍시 산외면,2739,1344,1344,1395
4518051000,45180510,3504051,전라북도 정읍시 수성동,18187,6706,8884,9303
4518052000,45180520,3504052,전라북도 정읍시 장명동,4187,1631,2006,2181
4518053500,45180535,3504053,전라북도 정읍시 내장상동,18411,6364,8976,9435
4518054500,45180545,3504054,전라북도 정읍시 시기동,4978,2048,2409,2569
4518056000,45180560,3504056,전라북도 정읍시 시기3동,9306,3231,4640,4666
4518057000,45180570,3504057,전라북도 정읍시 연지동,6008,2527,2973,3035
4518058000,45180580,3504058,전라북도 정읍시 농소동,5579,2192,2777,2802
4518059500,45180595,3504059,전라북도 정읍시 상교동,4676,1991,2388,2288
4519000000,45190000,#N/A,전라북도 남원시 ,88520,35320,43508,45012
4519025000,45190250,3505011,전라북도 남원시 운봉읍,4416,1911,2131,2285
4519031000,45190310,3505031,전라북도 남원시 주천면,2564,1065,1301,1263
4519032000,45190320,3505032,전라북도 남원시 수지면,1344,613,628,716
4519033000,45190330,3505033,전라북도 남원시 송동면,2569,1078,1277,1292
4519034000,45190340,3505034,전라북도 남원시 주생면,2204,987,1070,1134
4519035000,45190350,3505035,전라북도 남원시 금지면,2887,1243,1416,1471
4519036000,45190360,3505036,전라북도 남원시 대강면,2116,1027,993,1123
4519037000,45190370,3505037,전라북도 남원시 대산면,1935,734,954,981
4519038000,45190380,3505038,전라북도 남원시 사매면,1914,920,962,952
4519039000,45190390,3505039,전라북도 남원시 덕과면,1141,520,584,557
4519040000,45190400,3505040,전라북도 남원시 보절면,1813,845,944,869
4519041000,45190410,3505041,전라북도 남원시 산동면,2140,916,1085,1055
4519042000,45190420,3505042,전라북도 남원시 이백면,2662,1092,1354,1308
4519045000,45190450,3505044,전라북도 남원시 아영면,2182,977,1084,1098
4519046000,45190460,3505045,전라북도 남원시 산내면,2008,907,989,1019
4519047000,45190470,3505043,전라북도 남원시 인월면,3167,1289,1592,1575
4519051000,45190510,3505051,전라북도 남원시 동충동,4434,1712,2168,2266
4519052000,45190520,3505052,전라북도 남원시 죽항동,4977,2126,2399,2578
4519054000,45190540,3505054,전라북도 남원시 노암동,5931,2299,2833,3098
4519055000,45190550,3505055,전라북도 남원시 금동,4588,1825,2207,2381
4519056000,45190560,3505056,전라북도 남원시 왕정동,5160,1892,2549,2611
4519057000,45190570,3505057,전라북도 남원시 향교동,9470,3766,4712,4758
4519059000,45190590,3505059,전라북도 남원시 도통동,16898,5576,8276,8622
4521000000,45210000,#N/A,전라북도 김제시 ,96180,40289,48000,48180
4521025000,45210250,3506011,전라북도 김제시 만경읍,3792,1713,1929,1863
4521032000,45210320,3506031,전라북도 김제시 죽산면,3544,1625,1792,1752
4521033000,45210330,3506032,전라북도 김제시 백산면,3475,1490,1756,1719
4521034000,45210340,3506033,전라북도 김제시 용지면,5024,2130,2534,2490
4521035000,45210350,3506034,전라북도 김제시 백구면,5085,2083,2548,2537
4521036000,45210360,3506035,전라북도 김제시 부량면,1879,833,913,966
4521038000,45210380,3506036,전라북도 김제시 공덕면,3306,1391,1707,1599
4521039000,45210390,3506037,전라북도 김제시 청하면,2448,1070,1263,1185
4521040000,45210400,3506038,전라북도 김제시 성덕면,2382,1082,1226,1156
4521041000,45210410,3506039,전라북도 김제시 진봉면,3679,1726,1808,1871
4521042000,45210420,3506040,전라북도 김제시 금구면,5268,2289,2727,2541
4521043000,45210430,3506041,전라북도 김제시 봉남면,3050,1368,1471,1579
4521044000,45210440,3506042,전라북도 김제시 황산면,2506,1154,1296,1210
4521045000,45210450,3506043,전라북도 김제시 금산면,5662,2604,2838,2824
4521046000,45210460,3506044,전라북도 김제시 광활면,1825,794,934,891
4521051000,45210510,3506051,전라북도 김제시 요촌동,10247,4096,5035,5212
4521052000,45210520,3506052,전라북도 김제시 신풍동,15806,5858,7751,8055
4521054000,45210540,3506054,전라북도 김제시 검산동,10381,4004,5040,5341
4521056500,45210565,3506057,전라북도 김제시 교동월촌동,6821,2979,3432,3389
4571000000,45710000,#N/A,전라북도 완주군 ,83881,33913,43333,40548
4571025000,45710250,3531011,전라북도 완주군 삼례읍,16618,6696,8548,8070
4571025300,45710253,3531012,전라북도 완주군 봉동읍,20196,7599,10496,9700
4571031000,45710310,3531031,전라북도 완주군 용진면,8058,3140,4166,3892
4571032000,45710320,3531032,전라북도 완주군 상관면,5160,2036,2604,2556
4571033000,45710330,3531033,전라북도 완주군 이서면,6904,2758,3599,3305
4571034000,45710340,3531034,전라북도 완주군 소양면,6567,2781,3439,3128
4571035000,45710350,3531035,전라북도 완주군 구이면,5507,2334,2818,2689
4571036000,45710360,3531036,전라북도 완주군 고산면,5021,2068,2572,2449
4571037000,45710370,3531037,전라북도 완주군 비봉면,2139,951,1090,1049
4571038000,45710380,3531038,전라북도 완주군 운주면,2153,1039,1084,1069
4571039000,45710390,3531039,전라북도 완주군 화산면,3283,1492,1745,1538
4571040000,45710400,3531040,전라북도 완주군 동상면,1227,546,628,599
4571041000,45710410,3531041,전라북도 완주군 경천면,1048,473,544,504
4572000000,45720000,#N/A,전라북도 진안군 ,27145,11888,13706,13439
4572025000,45720250,3532011,전라북도 진안군 진안읍,10725,4504,5397,5328
4572031000,45720310,3532031,전라북도 진안군 용담면,925,483,456,469
4572032000,45720320,3532032,전라북도 진안군 안천면,1106,515,533,573
4572033000,45720330,3532033,전라북도 진안군 동향면,1582,732,756,826
4572034000,45720340,3532034,전라북도 진안군 상전면,958,434,509,449
4572035000,45720350,3532035,전라북도 진안군 백운면,2116,955,1076,1040
4572036000,45720360,3532036,전라북도 진안군 성수면,2054,933,1024,1030
4572037000,45720370,3532037,전라북도 진안군 마령면,2153,928,1116,1037
4572038000,45720380,3532038,전라북도 진안군 부귀면,2645,1143,1382,1263
4572039000,45720390,3532039,전라북도 진안군 정천면,1138,462,585,553
4572040000,45720400,3532040,전라북도 진안군 주천면,1743,799,872,871
4573000000,45730000,#N/A,전라북도 무주군 ,25169,10860,12510,12659
4573025000,45730250,3533011,전라북도 무주군 무주읍,9127,3716,4556,4571
4573031000,45730310,3533031,전라북도 무주군 무풍면,2397,1079,1190,1207
4573032000,45730320,3533032,전라북도 무주군 설천면,4332,1879,2155,2177
4573033000,45730330,3533033,전라북도 무주군 적상면,2826,1276,1407,1419
4573034000,45730340,3533034,전라북도 무주군 안성면,4974,2169,2460,2514
4573035000,45730350,3533035,전라북도 무주군 부남면,1513,741,742,771
4574000000,45740000,#N/A,전라북도 장수군 ,23930,10132,11961,11969
4574025000,45740250,3534011,전라북도 장수군 장수읍,7186,2891,3640,3546
4574031000,45740310,3534031,전라북도 장수군 산서면,2707,1187,1331,1376
4574032000,45740320,3534032,전라북도 장수군 번암면,2748,1257,1364,1384
4574033500,45740335,3534033,전라북도 장수군 장계면,4755,1978,2379,2376
4574034000,45740340,3534034,전라북도 장수군 천천면,2367,1049,1169,1198
4574035000,45740350,3534035,전라북도 장수군 계남면,2382,985,1193,1189
4574036000,45740360,3534036,전라북도 장수군 계북면,1785,785,885,900
4575000000,45750000,#N/A,전라북도 임실군 ,31278,13652,15822,15456
4575025000,45750250,3535011,전라북도 임실군 임실읍,6732,2843,3438,3294
4575031000,45750310,3535031,전라북도 임실군 청웅면,1630,720,817,813
4575032000,45750320,3535032,전라북도 임실군 운암면,2033,918,990,1043
4575033000,45750330,3535033,전라북도 임실군 신평면,1750,812,900,850
4575034000,45750340,3535034,전라북도 임실군 성수면,1891,841,954,937
4575035500,45750355,3535035,전라북도 임실군 오수면,5028,2147,2518,2510
4575036000,45750360,3535036,전라북도 임실군 신덕면,1543,732,817,726
4575037000,45750370,3535037,전라북도 임실군 삼계면,1786,835,866,920
4575038000,45750380,3535038,전라북도 임실군 관촌면,4072,1640,2109,1963
4575039000,45750390,3535039,전라북도 임실군 강진면,1905,843,1001,904
4575040000,45750400,3535040,전라북도 임실군 덕치면,1416,671,689,727
4575041000,45750410,3535041,전라북도 임실군 지사면,1492,650,723,769
4577000000,45770000,#N/A,전라북도 순창군 ,30254,13027,14763,15491
4577025000,45770250,3536011,전라북도 순창군 순창읍,10139,3915,4979,5160
4577031000,45770310,3536031,전라북도 순창군 인계면,1768,798,853,915
4577032000,45770320,3536032,전라북도 순창군 동계면,2354,1104,1125,1229
4577033000,45770330,3536035,전라북도 순창군 풍산면,1943,934,963,980
4577034000,45770340,3536036,전라북도 순창군 금과면,1917,882,939,978
4577035000,45770350,3536037,전라북도 순창군 팔덕면,1747,788,839,908
4577036000,45770360,3536039,전라북도 순창군 쌍치면,2314,994,1160,1154
4577037000,45770370,3536038,전라북도 순창군 복흥면,2516,1069,1221,1295
4577038000,45770380,3536033,전라북도 순창군 적성면,1483,699,706,777
4577039000,45770390,3536034,전라북도 순창군 유등면,1364,607,654,710
4577040000,45770400,3536040,전라북도 순창군 구림면,2709,1237,1324,1385
4579000000,45790000,#N/A,전라북도 고창군 ,60214,26490,29779,30435
4579025000,45790250,3537011,전라북도 고창군 고창읍,19647,7345,9725,9922
4579031000,45790310,3537031,전라북도 고창군 고수면,2813,1247,1419,1394
4579032000,45790320,3537032,전라북도 고창군 아산면,3171,1564,1601,1570
4579033000,45790330,3537033,전라북도 고창군 무장면,3600,1681,1797,1803
4579034000,45790340,3537034,전라북도 고창군 공음면,3087,1458,1557,1530
4579035000,45790350,3537035,전라북도 고창군 상하면,2917,1386,1394,1523
4579036000,45790360,3537036,전라북도 고창군 해리면,3523,1675,1698,1825
4579037000,45790370,3537037,전라북도 고창군 성송면,2195,1087,1097,1098
4579038000,45790380,3537038,전라북도 고창군 대산면,4375,2027,2212,2163
4579039000,45790390,3537039,전라북도 고창군 심원면,3083,1348,1511,1572
4579040000,45790400,3537040,전라북도 고창군 흥덕면,3746,1734,1830,1916
4579041000,45790410,3537041,전라북도 고창군 성내면,2379,1160,1173,1206
4579042000,45790420,3537042,전라북도 고창군 신림면,2581,1213,1270,1311
4579043000,45790430,3537043,전라북도 고창군 부안면,3097,1565,1495,1602
4580000000,45800000,#N/A,전라북도 부안군 ,60953,27094,30231,30722
4580025000,45800250,3538011,전라북도 부안군 부안읍,21239,8484,10431,10808
4580031000,45800310,3538031,전라북도 부안군 주산면,2535,1184,1225,1310
4580032000,45800320,3538032,전라북도 부안군 동진면,3905,1856,1968,1937
4580033000,45800330,3538033,전라북도 부안군 행안면,2672,1201,1345,1327
4580034000,45800340,3538034,전라북도 부안군 계화면,4985,2210,2525,2460
4580035000,45800350,3538035,전라북도 부안군 보안면,3061,1508,1501,1560
4580036000,45800360,3538036,전라북도 부안군 변산면,5245,2324,2637,2608
4580037000,45800370,3538037,전라북도 부안군 진서면,2901,1337,1455,1446
4580038000,45800380,3538038,전라북도 부안군 백산면,3361,1663,1676,1685
4580039000,45800390,3538039,전라북도 부안군 상서면,2711,1283,1329,1382
4580040000,45800400,3538040,전라북도 부안군 하서면,3492,1620,1726,1766
4580041000,45800410,3538041,전라북도 부안군 줄포면,3417,1641,1666,1751
4580042000,45800420,3538042,전라북도 부안군 위도면,1429,783,747,682
4600000000,46000000,#N/A,전라남도  ,1920578,772224,959101,961477
4611000000,46110000,#N/A,전라남도 목포시 ,244969,94615,122647,122322
4611051000,46110510,3601051,전라남도 목포시 용당1동,14660,6292,7349,7311
4611052000,46110520,3601052,전라남도 목포시 용당2동,7801,3365,3990,3811
4611053500,46110535,3601053,전라남도 목포시 연동,7303,3248,3676,3627
4611054500,46110545,3601055,전라남도 목포시 산정동,9319,3413,4685,4634
4611055400,46110554,3601056,전라남도 목포시 연산동,6577,2203,3274,3303
4611055800,46110558,3601057,전라남도 목포시 원산동,17827,6434,8865,8962
4611056500,46110565,3601058,전라남도 목포시 대성동,5306,2400,2638,2668
4611059500,46110595,3601060,전라남도 목포시 목원동,12091,5527,6114,5977
4611064000,46110640,3601062,전라남도 목포시 동명동,8707,3770,4528,4179
4611064500,46110645,3601063,전라남도 목포시 삼학동,7678,2802,3854,3824
4611065500,46110655,3601064,전라남도 목포시 만호동,4901,2344,2587,2314
4611066000,46110660,3601065,전라남도 목포시 유달동,7719,3577,3972,3747
4611069500,46110695,3601067,전라남도 목포시 죽교동,5181,2272,2624,2557
4611070500,46110705,3601068,전라남도 목포시 북항동,10946,4024,5486,5460
4611074500,46110745,3601069,전라남도 목포시 용해동,15132,5580,7511,7621
4611075000,46110750,3601070,전라남도 목포시 이로동,9788,3496,4931,4857
4611075600,46110756,3601071,전라남도 목포시 상동,20034,7717,9789,10245
4611075700,46110757,3601072,전라남도 목포시 하당동,12741,5301,6416,6325
4611075800,46110758,3601073,전라남도 목포시 신흥동,19274,6261,9573,9701
4611078000,46110780,3601074,전라남도 목포시 삼향동,6812,2716,3490,3322
4611079000,46110790,3601075,전라남도 목포시 옥암동,12970,4299,6279,6691
4611080000,46110800,3601076,전라남도 목포시 부흥동,22202,7574,11016,11186
4613000000,46130000,#N/A,전라남도 여수시 ,295229,106761,149228,146001
4613025000,46130250,3602011,전라남도 여수시 돌산읍,14965,5671,7539,7426
4613031000,46130310,3602031,전라남도 여수시 소라면,8722,3546,4460,4262
4613032000,46130320,3602032,전라남도 여수시 율촌면,7943,3176,4003,3940
4613033000,46130330,3602033,전라남도 여수시 화양면,8610,3546,4482,4128
4613034000,46130340,3602034,전라남도 여수시 남면,3858,1794,1945,1913
4613035000,46130350,3602035,전라남도 여수시 화정면,2919,1379,1429,1490
4613036000,46130360,3602036,전라남도 여수시 삼산면,2592,1210,1387,1205
4613051500,46130515,3602051,전라남도 여수시 동문동,6403,2740,3284,3119
4613053500,46130535,3602052,전라남도 여수시 한려동,5311,2250,2716,2595
4613057000,46130570,3602053,전라남도 여수시 중앙동,6879,2774,3445,3434
4613060000,46130600,3602054,전라남도 여수시 충무동,5959,2473,3086,2873
4613062500,46130625,3602055,전라남도 여수시 광림동,8902,3472,4590,4312
4613063500,46130635,3602056,전라남도 여수시 서강동,5313,2118,2666,2647
4613065500,46130655,3602057,전라남도 여수시 대교동,8396,3634,4288,4108
4613067000,46130670,3602058,전라남도 여수시 국동,13238,4753,6788,6450
4613068500,46130685,3602059,전라남도 여수시 월호동,9025,2988,4605,4420
4613070000,46130700,3602060,전라남도 여수시 여서동,24018,7699,11921,12097
4613071000,46130710,3602061,전라남도 여수시 문수동,22876,7996,11395,11481
4613073000,46130730,3602062,전라남도 여수시 미평동,14574,5123,7385,7189
4613074000,46130740,3602063,전라남도 여수시 둔덕동,11404,3625,5720,5684
4613076500,46130765,3602064,전라남도 여수시 만덕동,9693,3565,4907,4786
4613078000,46130780,3602065,전라남도 여수시 쌍봉동,35255,11524,17751,17504
4613079000,46130790,3602066,전라남도 여수시 시전동,20142,6651,10122,10020
4613080000,46130800,3602067,전라남도 여수시 여천동,22655,7589,11315,11340
4613081000,46130810,3602068,전라남도 여수시 주삼동,9101,2976,4592,4509
4613082000,46130820,3602069,전라남도 여수시 삼일동,5094,1966,2675,2419
4613083000,46130830,3602070,전라남도 여수시 묘도동,1382,523,732,650
4615000000,46150000,#N/A,전라남도 순천시 ,269881,95547,134866,135015
4615025000,46150250,3603011,전라남도 순천시 승주읍,3602,1570,1804,1798
4615031000,46150310,3603037,전라남도 순천시 해룡면,27017,8883,13681,13336
4615032000,46150320,3603038,전라남도 순천시 서면,11878,4495,5991,5887
4615033000,46150330,3603039,전라남도 순천시 황전면,3983,1794,1985,1998
4615034000,46150340,3603040,전라남도 순천시 월등면,2280,973,1125,1155
4615035000,46150350,3603031,전라남도 순천시 주암면,4265,2036,2123,2142
4615036000,46150360,3603032,전라남도 순천시 송광면,2126,938,1104,1022
4615037000,46150370,3603033,전라남도 순천시 외서면,1169,580,565,604
4615038000,46150380,3603034,전라남도 순천시 낙안면,4072,1748,2013,2059
4615039000,46150390,3603035,전라남도 순천시 별량면,7015,3007,3568,3447
4615040000,46150400,3603036,전라남도 순천시 상사면,3132,1200,1541,1591
4615051500,46150515,3603051,전라남도 순천시 향동,5778,2293,2882,2896
4615054000,46150540,3603054,전라남도 순천시 매곡동,6420,2516,3184,3236
4615055000,46150550,3603055,전라남도 순천시 삼산동,19690,6555,9880,9810
4615056000,46150560,3603056,전라남도 순천시 조곡동,8488,3213,4312,4176
4615057000,46150570,3603057,전라남도 순천시 덕연동,52883,16421,26306,26577
4615058000,46150580,3603058,전라남도 순천시 풍덕동,10301,3778,5184,5117
4615059000,46150590,3603059,전라남도 순천시 남제동,12642,4898,6362,6280
4615060000,46150600,3603060,전라남도 순천시 저전동,4080,1603,2027,2053
4615061000,46150610,3603061,전라남도 순천시 장천동,3532,1705,1793,1739
4615062000,46150620,3603062,전라남도 순천시 중앙동,4427,1918,2163,2264
4615063500,46150635,3603063,전라남도 순천시 도사동,9838,3824,5041,4797
4615066100,46150661,3603066,전라남도 순천시 왕조1동,37182,12583,18340,18842
4615066500,46150665,3603067,전라남도 순천시 왕조2동,24081,7016,11892,12189
4617000000,46170000,#N/A,전라남도 나주시 ,93341,40942,46826,46515
4617025000,46170250,3604011,전라남도 나주시 남평읍,8286,3688,4223,4063
4617031000,46170310,3604031,전라남도 나주시 세지면,3686,1692,1875,1811
4617032000,46170320,3604032,전라남도 나주시 왕곡면,4103,1813,2089,2014
4617033000,46170330,3604033,전라남도 나주시 반남면,2043,1003,1015,1028
4617034000,46170340,3604034,전라남도 나주시 공산면,3144,1485,1538,1606
4617035000,46170350,3604035,전라남도 나주시 동강면,3587,1758,1721,1866
4617036000,46170360,3604036,전라남도 나주시 다시면,4663,2224,2323,2340
4617037000,46170370,3604037,전라남도 나주시 문평면,2644,1325,1297,1347
4617038000,46170380,3604038,전라남도 나주시 노안면,5830,2595,3019,2811
4617039000,46170390,3604039,전라남도 나주시 금천면,6063,2528,3117,2946
4617040000,46170400,3604040,전라남도 나주시 산포면,4616,2072,2338,2278
4617042000,46170420,3604041,전라남도 나주시 다도면,2307,1126,1177,1130
4617043000,46170430,3604042,전라남도 나주시 봉황면,5593,2619,2828,2765
4617051000,46170510,3604051,전라남도 나주시 송월동,7370,2625,3617,3753
4617052000,46170520,3604052,전라남도 나주시 영강동,4169,1643,2064,2105
4617054000,46170540,3604054,전라남도 나주시 금남동,7601,3178,3794,3807
4617055000,46170550,3604055,전라남도 나주시 성북동,8867,3659,4383,4484
4617058000,46170580,3604058,전라남도 나주시 영산동,4640,2098,2308,2332
4617060000,46170600,3604060,전라남도 나주시 이창동,4129,1811,2100,2029
4623000000,46230000,#N/A,전라남도 광양시 ,140559,49931,71985,68574
4623025000,46230250,3606011,전라남도 광양시 광양읍,43820,15858,22036,21784
4623031000,46230310,3606031,전라남도 광양시 봉강면,2460,973,1257,1203
4623032000,46230320,3606032,전라남도 광양시 옥룡면,3311,1413,1688,1623
4623033000,46230330,3606033,전라남도 광양시 옥곡면,4120,1572,2074,2046
4623034000,46230340,3606034,전라남도 광양시 진상면,3705,1569,1858,1847
4623035000,46230350,3606035,전라남도 광양시 진월면,3838,1589,1969,1869
4623036000,46230360,3606036,전라남도 광양시 다압면,2078,911,1055,1023
4623051500,46230515,3606051,전라남도 광양시 골약동,2608,1117,1357,1251
4623053000,46230530,3606053,전라남도 광양시 중마동,42879,14234,21913,20966
4623054000,46230540,3606054,전라남도 광양시 광영동,12108,4474,6319,5789
4623055000,46230550,3606056,전라남도 광양시 금호동,16694,5072,8876,7818
4623057000,46230570,3606055,전라남도 광양시 태인동,2938,1149,1583,1355
4671000000,46710000,#N/A,전라남도 담양군 ,48552,20468,24624,23928
4671025000,46710250,3631011,전라남도 담양군 담양읍,14699,5834,7434,7265
4671031000,46710310,3631031,전라남도 담양군 봉산면,3079,1345,1586,1493
4671032000,46710320,3631032,전라남도 담양군 고서면,3797,1615,1920,1877
4671033000,46710330,3631033,전라남도 담양군 남면,1495,688,764,731
4671034000,46710340,3631034,전라남도 담양군 창평면,4251,1824,2126,2125
4671035000,46710350,3631035,전라남도 담양군 대덕면,2137,974,1096,1041
4671036000,46710360,3631036,전라남도 담양군 무정면,2856,1279,1449,1407
4671037000,46710370,3631037,전라남도 담양군 금성면,2853,1257,1428,1425
4671038000,46710380,3631038,전라남도 담양군 용면,1946,846,969,977
4671039000,46710390,3631039,전라남도 담양군 월산면,2743,1127,1424,1319
4671040000,46710400,3631040,전라남도 담양군 수북면,4147,1793,2109,2038
4671041000,46710410,3631041,전라남도 담양군 대전면,4549,1886,2319,2230
4672000000,46720000,#N/A,전라남도 곡성군 ,32779,14271,15875,16904
4672025000,46720250,3632011,전라남도 곡성군 곡성읍,8778,3526,4284,4494
4672031000,46720310,3632031,전라남도 곡성군 오곡면,2278,980,1104,1174
4672032000,46720320,3632032,전라남도 곡성군 삼기면,1944,910,931,1013
4672033000,46720330,3632033,전라남도 곡성군 석곡면,2968,1372,1407,1561
4672034000,46720340,3632034,전라남도 곡성군 목사동면,1689,785,821,868
4672035000,46720350,3632035,전라남도 곡성군 죽곡면,2067,948,1010,1057
4672036000,46720360,3632036,전라남도 곡성군 고달면,1418,656,667,751
4672037000,46720370,3632037,전라남도 곡성군 옥과면,4662,1988,2266,2396
4672038000,46720380,3632038,전라남도 곡성군 입면,3279,1381,1593,1686
4672039000,46720390,3632039,전라남도 곡성군 겸면,2054,954,989,1065
4672040000,46720400,3632040,전라남도 곡성군 오산면,1642,771,803,839
4673000000,46730000,#N/A,전라남도 구례군 ,27799,11750,13554,14245
4673025000,46730250,3633011,전라남도 구례군 구례읍,11642,4518,5730,5912
4673031000,46730310,3633031,전라남도 구례군 문척면,1352,598,675,677
4673032000,46730320,3633032,전라남도 구례군 간전면,1697,786,817,880
4673033000,46730330,3633033,전라남도 구례군 토지면,2696,1194,1316,1380
4673034000,46730340,3633034,전라남도 구례군 마산면,2869,1181,1412,1457
4673035000,46730350,3633035,전라남도 구례군 광의면,2629,1198,1227,1402
4673036000,46730360,3633036,전라남도 구례군 용방면,1574,723,769,805
4673037000,46730370,3633037,전라남도 구례군 산동면,3340,1552,1608,1732
4677000000,46770000,#N/A,전라남도 고흥군 ,76872,35130,37206,39666
4677025000,46770250,3635011,전라남도 고흥군 고흥읍,12925,5108,6300,6625
4677025300,46770253,3635012,전라남도 고흥군 도양읍,12288,5432,6103,6185
4677031000,46770310,3635031,전라남도 고흥군 풍양면,4134,1975,1983,2151
4677032000,46770320,3635032,전라남도 고흥군 도덕면,3650,1763,1733,1917
4677033000,46770330,3635033,전라남도 고흥군 금산면,5406,2555,2727,2679
4677034000,46770340,3635034,전라남도 고흥군 도화면,5042,2364,2427,2615
4677035000,46770350,3635035,전라남도 고흥군 포두면,6181,2883,2979,3202
4677036000,46770360,3635036,전라남도 고흥군 봉래면,2441,1200,1201,1240
4677037000,46770370,3635038,전라남도 고흥군 점암면,3356,1698,1563,1793
4677038000,46770380,3635040,전라남도 고흥군 과역면,4271,2019,2000,2271
4677039000,46770390,3635041,전라남도 고흥군 남양면,2901,1373,1349,1552
4677040000,46770400,3635042,전라남도 고흥군 동강면,3892,1762,1901,1991
4677041000,46770410,3635043,전라남도 고흥군 대서면,3010,1430,1459,1551
4677042000,46770420,3635044,전라남도 고흥군 두원면,3807,1863,1774,2033
4677044000,46770440,3635039,전라남도 고흥군 영남면,1705,837,789,916
4677045000,46770450,3635037,전라남도 고흥군 동일면,1863,868,918,945
4678000000,46780000,#N/A,전라남도 보성군 ,50188,22680,24327,25861
4678025000,46780250,3636011,전라남도 보성군 보성읍,10434,4284,5053,5381
4678025300,46780253,3636012,전라남도 보성군 벌교읍,15286,6722,7538,7748
4678031000,46780310,3636031,전라남도 보성군 노동면,1347,667,640,707
4678032000,46780320,3636032,전라남도 보성군 미력면,1741,819,840,901
4678033000,46780330,3636033,전라남도 보성군 겸백면,1493,764,705,788
4678034000,46780340,3636034,전라남도 보성군 율어면,1548,757,735,813
4678035000,46780350,3636035,전라남도 보성군 복내면,2118,1024,1036,1082
4678036000,46780360,3636036,전라남도 보성군 문덕면,1106,566,516,590
4678037000,46780370,3636037,전라남도 보성군 조성면,4792,2273,2309,2483
4678038000,46780380,3636038,전라남도 보성군 득량면,5153,2421,2460,2693
4678039000,46780390,3636039,전라남도 보성군 회천면,3755,1707,1821,1934
4678040000,46780400,3636040,전라남도 보성군 웅치면,1415,676,674,741
4679000000,46790000,#N/A,전라남도 화순군 ,70624,29006,35033,35591
4679025000,46790250,3637011,전라남도 화순군 화순읍,42054,15406,20892,21162
4679031000,46790310,3637031,전라남도 화순군 한천면,1831,889,912,919
4679032000,46790320,3637032,전라남도 화순군 춘양면,2386,1147,1165,1221
4679033000,46790330,3637033,전라남도 화순군 청풍면,1377,697,677,700
4679034000,46790340,3637034,전라남도 화순군 이양면,2335,1135,1107,1228
4679035000,46790350,3637035,전라남도 화순군 능주면,3863,1632,1929,1934
4679036000,46790360,3637036,전라남도 화순군 도곡면,3085,1442,1536,1549
4679037000,46790370,3637037,전라남도 화순군 도암면,1655,831,845,810
4679038000,46790380,3637038,전라남도 화순군 이서면,1062,537,535,527
4679039000,46790390,3637039,전라남도 화순군 북면,2009,1002,977,1032
4679040000,46790400,3637040,전라남도 화순군 동복면,2042,1019,993,1049
4679041000,46790410,3637041,전라남도 화순군 남면,2747,1315,1360,1387
4679042000,46790420,3637042,전라남도 화순군 동면,4178,1954,2105,2073
4680000000,46800000,#N/A,전라남도 장흥군 ,42935,19316,20712,22223
4680025000,46800250,3638011,전라남도 장흥군 장흥읍,15516,6400,7516,8000
4680025300,46800253,3638012,전라남도 장흥군 관산읍,6438,2899,3103,3335
4680025600,46800256,3638013,전라남도 장흥군 대덕읍,4292,1967,2078,2214
4680031000,46800310,3638031,전라남도 장흥군 용산면,2736,1305,1289,1447
4680032000,46800320,3638032,전라남도 장흥군 안양면,3408,1635,1628,1780
4680033000,46800330,3638033,전라남도 장흥군 장동면,1475,709,711,764
4680034000,46800340,3638034,전라남도 장흥군 장평면,2618,1337,1266,1352
4680035000,46800350,3638035,전라남도 장흥군 유치면,1314,671,657,657
4680036000,46800360,3638036,전라남도 장흥군 부산면,1657,878,759,898
4680037000,46800370,3638037,전라남도 장흥군 회진면,3481,1515,1705,1776
4681000000,46810000,#N/A,전라남도 강진군 ,40937,18255,19519,21418
4681025000,46810250,3639011,전라남도 강진군 강진읍,15717,6317,7514,8203
4681031000,46810310,3639031,전라남도 강진군 군동면,4269,1959,2060,2209
4681032000,46810320,3639032,전라남도 강진군 칠량면,2899,1390,1388,1511
4681033000,46810330,3639033,전라남도 강진군 대구면,1494,728,695,799
4681034000,46810340,3639035,전라남도 강진군 도암면,3285,1512,1565,1720
4681035000,46810350,3639036,전라남도 강진군 신전면,2188,1028,1048,1140
4681036000,46810360,3639037,전라남도 강진군 성전면,3403,1576,1635,1768
4681037000,46810370,3639038,전라남도 강진군 작천면,2397,1140,1117,1280
4681038000,46810380,3639039,전라남도 강진군 병영면,2165,1082,999,1166
4681039000,46810390,3639040,전라남도 강진군 옴천면,951,511,450,501
4681040000,46810400,3639034,전라남도 강진군 마량면,2169,1012,1048,1121
4682000000,46820000,#N/A,전라남도 해남군 ,81247,34919,39853,41394
4682025000,46820250,3640011,전라남도 해남군 해남읍,25100,9337,12344,12756
4682031000,46820310,3640031,전라남도 해남군 삼산면,3550,1541,1746,1804
4682032000,46820320,3640032,전라남도 해남군 화산면,4210,1940,2104,2106
4682033000,46820330,3640033,전라남도 해남군 현산면,3807,1782,1871,1936
4682034000,46820340,3640034,전라남도 해남군 송지면,7613,3246,3722,3891
4682035000,46820350,3640035,전라남도 해남군 북평면,3538,1618,1689,1849
4682036000,46820360,3640036,전라남도 해남군 북일면,2530,1158,1211,1319
4682037000,46820370,3640037,전라남도 해남군 옥천면,3561,1672,1679,1882
4682038000,46820380,3640038,전라남도 해남군 계곡면,2727,1348,1271,1456
4682039000,46820390,3640039,전라남도 해남군 마산면,2951,1458,1463,1488
4682040000,46820400,3640040,전라남도 해남군 황산면,6485,2866,3202,3283
4682041000,46820410,3640041,전라남도 해남군 산이면,5474,2428,2722,2752
4682042000,46820420,3640042,전라남도 해남군 문내면,5027,2285,2460,2567
4682043000,46820430,3640043,전라남도 해남군 화원면,4674,2240,2369,2305
4683000000,46830000,#N/A,전라남도 영암군 ,60221,25924,30461,29760
4683025000,46830250,3641011,전라남도 영암군 영암읍,9566,3815,4670,4896
4683025300,46830253,3641012,전라남도 영암군 삼호읍,20911,8103,11200,9711
4683031000,46830310,3641031,전라남도 영암군 덕진면,2141,1037,1042,1099
4683032000,46830320,3641032,전라남도 영암군 금정면,2334,1137,1118,1216
4683033000,46830330,3641033,전라남도 영암군 신북면,4719,2220,2370,2349
4683034000,46830340,3641034,전라남도 영암군 시종면,4809,2355,2382,2427
4683035000,46830350,3641035,전라남도 영암군 도포면,2824,1398,1408,1416
4683036000,46830360,3641036,전라남도 영암군 군서면,3919,1827,1872,2047
4683037000,46830370,3641037,전라남도 영암군 서호면,2364,1101,1116,1248
4683038000,46830380,3641038,전라남도 영암군 학산면,3681,1591,1793,1888
4683039000,46830390,3641039,전라남도 영암군 미암면,2953,1340,1490,1463
4684000000,46840000,#N/A,전라남도 무안군 ,66294,27948,33356,32938
4684025000,46840250,3642011,전라남도 무안군 무안읍,10979,4441,5469,5510
4684025300,46840253,3642012,전라남도 무안군 일로읍,8504,3663,4317,4187
4684031000,46840310,3642031,전라남도 무안군 삼향면,14879,5398,7546,7333
4684032000,46840320,3642032,전라남도 무안군 몽탄면,4168,2006,2050,2118
4684033000,46840330,3642033,전라남도 무안군 청계면,7904,3563,3958,3946
4684034000,46840340,3642034,전라남도 무안군 현경면,6383,2888,3179,3204
4684035000,46840350,3642035,전라남도 무안군 망운면,2820,1220,1434,1386
4684036000,46840360,3642036,전라남도 무안군 해제면,6630,3051,3317,3313
4684037000,46840370,3642037,전라남도 무안군 운남면,4027,1718,2086,1941
4686000000,46860000,#N/A,전라남도 함평군 ,37549,17462,18595,18954
4686025000,46860250,3643011,전라남도 함평군 함평읍,9599,4159,4685,4914
4686031000,46860310,3643031,전라남도 함평군 손불면,4234,2025,2087,2147
4686032000,46860320,3643032,전라남도 함평군 신광면,2125,1094,1052,1073
4686033000,46860330,3643033,전라남도 함평군 학교면,4822,2236,2386,2436
4686034000,46860340,3643034,전라남도 함평군 엄다면,2411,1167,1170,1241
4686035000,46860350,3643035,전라남도 함평군 대동면,3332,1551,1630,1702
4686036000,46860360,3643036,전라남도 함평군 나산면,3413,1666,1705,1708
4686037000,46860370,3643037,전라남도 함평군 해보면,3229,1536,1650,1579
4686038000,46860380,3643038,전라남도 함평군 월야면,4384,2028,2230,2154
4687000000,46870000,#N/A,전라남도 영광군 ,58284,24911,28966,29318
4687025000,46870250,3644011,전라남도 영광군 영광읍,21182,8153,10430,10752
4687025300,46870253,3644012,전라남도 영광군 백수읍,5622,2665,2754,2868
4687025600,46870256,3644013,전라남도 영광군 홍농읍,8048,3185,4148,3900
4687031000,46870310,3644031,전라남도 영광군 대마면,1975,906,998,977
4687032000,46870320,3644032,전라남도 영광군 묘량면,2029,941,978,1051
4687033000,46870330,3644033,전라남도 영광군 불갑면,1507,714,726,781
4687034000,46870340,3644034,전라남도 영광군 군서면,2602,1223,1310,1292
4687035000,46870350,3644035,전라남도 영광군 군남면,2866,1458,1376,1490
4687036000,46870360,3644036,전라남도 영광군 염산면,5127,2416,2516,2611
4687037000,46870370,3644037,전라남도 영광군 법성면,6617,2862,3308,3309
4687038000,46870380,3644038,전라남도 영광군 낙월면,709,388,422,287
4688000000,46880000,#N/A,전라남도 장성군 ,46719,20269,23828,22891
4688025000,46880250,3645011,전라남도 장성군 장성읍,13188,5422,6653,6535
4688031000,46880310,3645031,전라남도 장성군 진원면,3164,1422,1611,1553
4688032000,46880320,3645032,전라남도 장성군 남면,3824,1712,1981,1843
4688033000,46880330,3645033,전라남도 장성군 동화면,2170,988,1114,1056
4688034000,46880340,3645034,전라남도 장성군 삼서면,3142,1474,1623,1519
4688035000,46880350,3645035,전라남도 장성군 삼계면,7121,2767,3653,3468
4688036000,46880360,3645036,전라남도 장성군 황룡면,4891,2081,2506,2385
4688037000,46880370,3645037,전라남도 장성군 서삼면,1657,727,871,786
4688038000,46880380,3645038,전라남도 장성군 북일면,1652,768,810,842
4688039000,46880390,3645039,전라남도 장성군 북이면,3306,1520,1699,1607
4688040000,46880400,3645040,전라남도 장성군 북하면,2604,1388,1307,1297
4689000000,46890000,#N/A,전라남도 완도군 ,55154,24777,27399,27755
4689025000,46890250,3646011,전라남도 완도군 완도읍,19822,8104,9986,9836
4689025300,46890253,3646012,전라남도 완도군 금일읍,4051,1953,2022,2029
4689025600,46890256,3646013,전라남도 완도군 노화읍,5809,2554,2948,2861
4689031000,46890310,3646031,전라남도 완도군 군외면,3738,1881,1836,1902
4689032000,46890320,3646032,전라남도 완도군 신지면,3881,1820,1931,1950
4689033000,46890330,3646033,전라남도 완도군 고금면,4656,2260,2221,2435
4689034000,46890340,3646034,전라남도 완도군 약산면,2595,1276,1277,1318
4689035000,46890350,3646035,전라남도 완도군 청산면,2631,1332,1262,1369
4689036000,46890360,3646036,전라남도 완도군 소안면,3025,1403,1447,1578
4689037000,46890370,3646037,전라남도 완도군 금당면,1175,554,578,597
4689038000,46890380,3646038,전라남도 완도군 보길면,2822,1143,1438,1384
4689039000,46890390,3646039,전라남도 완도군 생일면,949,497,453,496
4690000000,46900000,#N/A,전라남도 진도군 ,34549,15634,16647,17902
4690025000,46900250,3647011,전라남도 진도군 진도읍,10765,4305,5266,5499
4690031000,46900310,3647031,전라남도 진도군 군내면,3618,1647,1752,1866
4690032000,46900320,3647032,전라남도 진도군 고군면,4256,1872,2024,2232
4690033000,46900330,3647033,전라남도 진도군 의신면,4295,2027,2062,2233
4690034000,46900340,3647034,전라남도 진도군 임회면,4150,2003,1964,2186
4690035000,46900350,3647035,전라남도 진도군 지산면,4056,1986,1918,2138
4690036000,46900360,3647036,전라남도 진도군 조도면,3409,1794,1661,1748
4691000000,46910000,#N/A,전라남도 신안군 ,45896,21708,23594,22302
4691025000,46910250,3648011,전라남도 신안군 지도읍,5248,2582,2743,2505
4691031000,46910310,3648031,전라남도 신안군 증도면,2196,1029,1201,995
4691032000,46910320,3648032,전라남도 신안군 임자면,3745,1725,1962,1783
4691033000,46910330,3648033,전라남도 신안군 자은면,2488,1255,1277,1211
4691034000,46910340,3648034,전라남도 신안군 비금면,3913,1866,1938,1975
4691035000,46910350,3648035,전라남도 신안군 도초면,3158,1507,1579,1579
4691036000,46910360,3648036,전라남도 신안군 흑산면,4737,2272,2548,2189
4691037000,46910370,3648037,전라남도 신안군 하의면,2002,1026,1028,974
4691038000,46910380,3648038,전라남도 신안군 신의면,1818,791,959,859
4691039000,46910390,3648039,전라남도 신안군 장산면,1909,956,964,945
4691040000,46910400,3648040,전라남도 신안군 안좌면,3734,1807,1870,1864
4691041000,46910410,3648041,전라남도 신안군 팔금면,1312,652,620,692
4691042000,46910420,3648042,전라남도 신안군 암태면,2345,1129,1147,1198
4691043000,46910430,3648043,전라남도 신안군 압해면,7291,3111,3758,3533
4700000000,47000000,#N/A,경상북도  ,2674448,1056030,1343403,1331045
4711000000,47110000,#N/A,경상북도 포항시 ,507371,186381,258047,249324
4711100000,47111000,#N/A,경상북도 포항시 남구 ,254212,94358,130999,123213
4711125000,47111250,3701111,경상북도 포항시 남구 구룡포읍,11343,5095,5770,5573
4711125300,47111253,3701112,경상북도 포항시 남구 연일읍,34117,11157,17561,16556
4711125600,47111256,3701113,경상북도 포항시 남구 오천읍,43588,16016,22866,20722
4711131000,47111310,3701131,경상북도 포항시 남구 대송면,6087,2458,3217,2870
4711132000,47111320,3701132,경상북도 포항시 남구 동해면,13103,4861,6665,6438
4711133000,47111330,3701133,경상북도 포항시 남구 장기면,5711,2627,2801,2910
4711134000,47111340,3701134,경상북도 포항시 남구 대보면,2690,1231,1328,1362
4711151000,47111510,3701151,경상북도 포항시 남구 상대1동,18969,7497,9754,9215
4711152000,47111520,3701152,경상북도 포항시 남구 상대2동,11858,4737,6082,5776
4711153000,47111530,3701153,경상북도 포항시 남구 해도1동,12412,5105,6215,6197
4711154000,47111540,3701154,경상북도 포항시 남구 해도2동,13480,5740,7010,6470
4711155000,47111550,3701155,경상북도 포항시 남구 송도동,19712,7864,10102,9610
4711156000,47111560,3701156,경상북도 포항시 남구 청림동,8102,3231,4335,3767
4711157000,47111570,3701157,경상북도 포항시 남구 제철동,3652,1551,2004,1648
4711158000,47111580,3701158,경상북도 포항시 남구 효곡동,29111,8812,15174,13937
4711159000,47111590,3701159,경상북도 포항시 남구 대이동,20277,6376,10115,10162
4711300000,47113000,#N/A,경상북도 포항시 북구 ,253159,92023,127048,126111
4711325000,47113250,3701211,경상북도 포항시 북구 흥해읍,36468,13722,18387,18081
4711331000,47113310,3701231,경상북도 포항시 북구 신광면,3429,1569,1750,1679
4711332000,47113320,3701232,경상북도 포항시 북구 청하면,6141,2733,3025,3116
4711333000,47113330,3701233,경상북도 포항시 북구 송라면,3267,1495,1557,1710
4711334000,47113340,3701234,경상북도 포항시 북구 기계면,5911,2566,2897,3014
4711335000,47113350,3701235,경상북도 포항시 북구 죽장면,2979,1453,1483,1496
4711336000,47113360,3701236,경상북도 포항시 북구 기북면,1403,675,697,706
4711352000,47113520,3701252,경상북도 포항시 북구 중앙동,6797,3353,3342,3455
4711356000,47113560,3701256,경상북도 포항시 북구 학산동,14477,5723,7178,7299
4711363000,47113630,3701258,경상북도 포항시 북구 양학동,21772,7116,10972,10800
4711364000,47113640,3701259,경상북도 포항시 북구 죽도1동,4171,1847,2095,2076
4711365000,47113650,3701260,경상북도 포항시 북구 죽도2동,19756,8071,9940,9816
4711366500,47113665,3701261,경상북도 포항시 북구 용흥동,28304,9687,14334,13970
4711368000,47113680,3701263,경상북도 포항시 북구 우창동,26878,9082,13347,13531
4711369000,47113690,3701264,경상북도 포항시 북구 두호동,28058,8818,14118,13940
4711370000,47113700,3701265,경상북도 포항시 북구 장량동,30959,9981,15699,15260
4711371000,47113710,3701266,경상북도 포항시 북구 환여동,12389,4132,6227,6162
4713000000,47130000,#N/A,경상북도 경주시 ,269896,105554,134946,134950
4713025000,47130250,3702011,경상북도 경주시 감포읍,6893,3096,3458,3435
4713025300,47130253,3702012,경상북도 경주시 안강읍,33064,12670,16659,16405
4713025600,47130256,3702013,경상북도 경주시 건천읍,10744,4518,5447,5297
4713025900,47130259,3702014,경상북도 경주시 외동읍,17098,7024,8740,8358
4713031000,47130310,3702031,경상북도 경주시 양북면,4490,2017,2292,2198
4713032000,47130320,3702032,경상북도 경주시 양남면,6919,2957,3570,3349
4713033000,47130330,3702033,경상북도 경주시 내남면,5818,2523,2941,2877
4713034000,47130340,3702034,경상북도 경주시 산내면,3468,1777,1718,1750
4713035000,47130350,3702035,경상북도 경주시 서면,3951,1815,1973,1978
4713036000,47130360,3702036,경상북도 경주시 현곡면,16927,5763,8319,8608
4713037000,47130370,3702037,경상북도 경주시 강동면,8251,3696,4192,4059
4713038000,47130380,3702038,경상북도 경주시 천북면,5892,2313,3007,2885
4713051500,47130515,3702051,경상북도 경주시 중부동,6860,3038,3406,3454
4713052000,47130520,3702052,경상북도 경주시 성동동,4663,1922,2293,2370
4713053000,47130530,3702053,경상북도 경주시 황오동,5325,2349,2647,2678
4713055000,47130550,3702055,경상북도 경주시 성건동,18261,7742,9120,9141
4713056000,47130560,3702056,경상북도 경주시 탑정동,5634,2500,2817,2817
4713057000,47130570,3702057,경상북도 경주시 황남동,3085,1368,1505,1580
4713059000,47130590,3702059,경상북도 경주시 선도동,13610,4885,6817,6793
4713060500,47130605,3702058,경상북도 경주시 월성동,6333,2826,3154,3179
4713061500,47130615,3702062,경상북도 경주시 용강동,15761,5284,7733,8028
4713062100,47130621,3702063,경상북도 경주시 황성동,29202,9404,14479,14723
4713063000,47130630,3702064,경상북도 경주시 동천동,26578,9345,13220,13358
4713065000,47130650,3702066,경상북도 경주시 불국동,8868,3734,4323,4545
4713066000,47130660,3702067,경상북도 경주시 보덕동,2201,988,1116,1085
4715000000,47150000,#N/A,경상북도 김천시 ,138153,52901,68602,69551
4715025000,47150250,3703011,경상북도 김천시 아포읍,8864,3516,4479,4385
4715031000,47150310,3703031,경상북도 김천시 농소면,3335,1289,1661,1674
4715032000,47150320,3703032,경상북도 김천시 남면,4019,1606,2008,2011
4715034000,47150340,3703033,경상북도 김천시 개령면,3005,1150,1513,1492
4715035000,47150350,3703034,경상북도 김천시 감문면,4091,1775,2008,2083
4715036000,47150360,3703035,경상북도 김천시 어모면,5332,2199,2675,2657
4715037000,47150370,3703036,경상북도 김천시 봉산면,3676,1465,1852,1824
4715038000,47150380,3703037,경상북도 김천시 대항면,4285,1619,2190,2095
4715039000,47150390,3703038,경상북도 김천시 감천면,2330,889,1190,1140
4715040000,47150400,3703039,경상북도 김천시 조마면,2738,1119,1386,1352
4715041000,47150410,3703040,경상북도 김천시 구성면,3468,1616,1711,1757
4715042000,47150420,3703041,경상북도 김천시 지례면,1954,908,972,982
4715043000,47150430,3703042,경상북도 김천시 부항면,1461,669,706,755
4715044000,47150440,3703043,경상북도 김천시 대덕면,2612,1162,1276,1336
4715045000,47150450,3703044,경상북도 김천시 증산면,1303,588,597,706
4715051600,47150516,3703060,경상북도 김천시 자산동,9952,3956,4916,5036
4715053600,47150536,3703061,경상북도 김천시 평화남산동,11367,4603,5647,5720
4715056500,47150565,3703055,경상북도 김천시 양금동,6009,2349,2965,3044
4715057500,47150575,3703056,경상북도 김천시 대신동,24556,8348,12168,12388
4715059500,47150595,3703058,경상북도 김천시 대곡동,23467,8254,11537,11930
4715061000,47150610,3703059,경상북도 김천시 지좌동,10329,3821,5145,5184
4717000000,47170000,#N/A,경상북도 안동시 ,167637,65804,83283,84354
4717025000,47170250,3704011,경상북도 안동시 풍산읍,7611,3273,3792,3819
4717031000,47170310,3704031,경상북도 안동시 와룡면,4582,2045,2372,2210
4717032000,47170320,3704032,경상북도 안동시 북후면,3812,1510,1943,1869
4717033000,47170330,3704033,경상북도 안동시 서후면,4032,1788,2061,1971
4717034000,47170340,3704034,경상북도 안동시 풍천면,4914,2210,2464,2450
4717035000,47170350,3704035,경상북도 안동시 일직면,3601,1612,1748,1853
4717036000,47170360,3704036,경상북도 안동시 남후면,2273,1060,1136,1137
4717037000,47170370,3704037,경상북도 안동시 남선면,2637,1113,1358,1279
4717038000,47170380,3704038,경상북도 안동시 임하면,3620,1341,1876,1744
4717039000,47170390,3704039,경상북도 안동시 길안면,3439,1610,1755,1684
4717040000,47170400,3704040,경상북도 안동시 임동면,2288,1082,1179,1109
4717041000,47170410,3704041,경상북도 안동시 예안면,2166,1032,1101,1065
4717042000,47170420,3704042,경상북도 안동시 도산면,2106,971,1081,1025
4717043000,47170430,3704043,경상북도 안동시 녹전면,2048,945,1040,1008
4717051000,47170510,3704051,경상북도 안동시 중구동,6228,2876,3069,3159
4717052000,47170520,3704052,경상북도 안동시 명륜동,6692,2500,3303,3389
4717055500,47170555,3704054,경상북도 안동시 용상동,22822,8405,11333,11489
4717058500,47170585,3704062,경상북도 안동시 서구동,9198,3911,4499,4699
4717060000,47170600,3704056,경상북도 안동시 태화동,14668,5977,7385,7283
4717062000,47170620,3704058,경상북도 안동시 평화동,8560,3111,4264,4296
4717063000,47170630,3704059,경상북도 안동시 안기동,8670,3009,4289,4381
4717065000,47170650,3704060,경상북도 안동시 옥동,20012,7125,9596,10416
4717066000,47170660,3704061,경상북도 안동시 송하동,11464,4007,5635,5829
4717069000,47170690,3704063,경상북도 안동시 강남동,10194,3291,5004,5190
4719000000,47190000,#N/A,경상북도 구미시 ,393474,148999,200009,193465
4719025000,47190250,3705011,경상북도 구미시 선산읍,16966,6084,8500,8466
4719025300,47190253,3705012,경상북도 구미시 고아읍,31163,9920,15917,15246
4719031000,47190310,3705031,경상북도 구미시 무을면,2404,1008,1211,1193
4719032000,47190320,3705032,경상북도 구미시 옥성면,2159,907,1087,1072
4719033000,47190330,3705033,경상북도 구미시 도개면,2816,1184,1427,1389
4719034000,47190340,3705034,경상북도 구미시 해평면,5952,2471,3040,2912
4719035000,47190350,3705035,경상북도 구미시 산동면,4361,1823,2298,2063
4719036000,47190360,3705036,경상북도 구미시 장천면,3907,1549,1992,1915
4719051000,47190510,3705051,경상북도 구미시 송정동,21328,7740,10520,10808
4719052000,47190520,3705052,경상북도 구미시 원평1동,5312,2918,2656,2656
4719053000,47190530,3705053,경상북도 구미시 원평2동,5395,2540,2765,2630
4719055100,47190551,3705055,경상북도 구미시 도량동,35319,11322,17733,17586
4719055500,47190555,3705056,경상북도 구미시 지산동,3712,1387,1974,1738
4719056500,47190565,3705057,경상북도 구미시 선주원남동,38702,13001,19780,18922
4719058200,47190582,3705059,경상북도 구미시 형곡1동,17550,5555,8772,8778
4719058300,47190583,3705060,경상북도 구미시 형곡2동,23780,7607,11980,11800
4719059000,47190590,3705061,경상북도 구미시 신평1동,5052,2364,2696,2356
4719060000,47190600,3705062,경상북도 구미시 신평2동,3779,1547,2001,1778
4719061000,47190610,3705063,경상북도 구미시 비산동,4639,1581,2437,2202
4719062100,47190621,3705064,경상북도 구미시 공단1동,4829,2052,2605,2224
4719062200,47190622,3705065,경상북도 구미시 공단2동,3683,2295,1930,1753
4719063000,47190630,3705066,경상북도 구미시 광평동,3015,1202,1604,1411
4719064500,47190645,3705067,경상북도 구미시 상모사곡동,29692,10566,15183,14509
4719066000,47190660,3705069,경상북도 구미시 임오동,16107,5200,8377,7730
4719067000,47190670,3705070,경상북도 구미시 인동동,53485,21361,27048,26437
4719068000,47190680,3705071,경상북도 구미시 진미동,22277,14077,10704,11573
4719069000,47190690,3705072,경상북도 구미시 양포동,26090,9738,13772,12318
4721000000,47210000,#N/A,경상북도 영주시 ,114163,44818,56891,57272
4721025000,47210250,3706011,경상북도 영주시 풍기읍,12665,5128,6298,6367
4721031000,47210310,3706031,경상북도 영주시 이산면,3131,1280,1603,1528
4721032000,47210320,3706032,경상북도 영주시 평은면,2265,1000,1153,1112
4721033000,47210330,3706033,경상북도 영주시 문수면,2053,900,1042,1011
4721034000,47210340,3706034,경상북도 영주시 장수면,2592,1073,1326,1266
4721035000,47210350,3706035,경상북도 영주시 안정면,3557,1529,1786,1771
4721036000,47210360,3706036,경상북도 영주시 봉현면,3131,1282,1585,1546
4721037000,47210370,3706037,경상북도 영주시 순흥면,2404,1002,1210,1194
4721038000,47210380,3706038,경상북도 영주시 단산면,2287,1034,1116,1171
4721039000,47210390,3706039,경상북도 영주시 부석면,3571,1557,1846,1725
4721051000,47210510,3706051,경상북도 영주시 상망동,9622,3679,4828,4794
4721052500,47210525,3706053,경상북도 영주시 하망동,8025,3010,3920,4105
4721055000,47210550,3706055,경상북도 영주시 영주1동,5766,2632,2815,2951
4721056000,47210560,3706058,경상북도 영주시 영주2동,5105,2029,2515,2590
4721059000,47210590,3706059,경상북도 영주시 휴천1동,7930,2656,3926,4004
4721060000,47210600,3706060,경상북도 영주시 휴천2동,10931,4108,5436,5495
4721061000,47210610,3706061,경상북도 영주시 휴천3동,10658,3721,5351,5307
4721062000,47210620,3706062,경상북도 영주시 가흥1동,10490,4373,5134,5356
4721063000,47210630,3706063,경상북도 영주시 가흥2동,7980,2825,4001,3979
4723000000,47230000,#N/A,경상북도 영천시 ,104218,43497,52180,52038
4723025000,47230250,3707011,경상북도 영천시 금호읍,12865,5852,6559,6306
4723031000,47230310,3707031,경상북도 영천시 청통면,4820,2084,2479,2341
4723032000,47230320,3707032,경상북도 영천시 신녕면,4775,2162,2376,2399
4723033000,47230330,3707033,경상북도 영천시 화산면,3708,1594,1881,1827
4723034000,47230340,3707034,경상북도 영천시 화북면,2460,1172,1186,1274
4723035000,47230350,3707035,경상북도 영천시 화남면,3279,1550,1685,1594
4723036000,47230360,3707036,경상북도 영천시 자양면,1169,601,580,589
4723037000,47230370,3707037,경상북도 영천시 임고면,4450,1980,2263,2187
4723038000,47230380,3707038,경상북도 영천시 고경면,6187,2715,3079,3108
4723039000,47230390,3707039,경상북도 영천시 북안면,4887,2163,2465,2422
4723040000,47230400,3707040,경상북도 영천시 대창면,3229,1451,1635,1594
4723051000,47230510,3707051,경상북도 영천시 동부동,27018,9806,13378,13640
4723052000,47230520,3707052,경상북도 영천시 중앙동,9486,3596,4639,4847
4723053500,47230535,3707053,경상북도 영천시 서부동,6424,2675,3189,3235
4723054000,47230540,3707054,경상북도 영천시 완산동,5149,2193,2535,2614
4723055500,47230555,3707055,경상북도 영천시 남부동,4312,1903,2251,2061
4725000000,47250000,#N/A,경상북도 상주시 ,105799,43441,52014,53785
4725025000,47250250,3708011,경상북도 상주시 함창읍,7271,3061,3545,3726
4725031000,47250310,3708032,경상북도 상주시 중동면,1860,790,897,963
4725032000,47250320,3708031,경상북도 상주시 사벌면,4474,1905,2193,2281
4725033000,47250330,3708033,경상북도 상주시 낙동면,4811,2093,2330,2481
4725034000,47250340,3708034,경상북도 상주시 청리면,3497,1453,1714,1783
4725035000,47250350,3708035,경상북도 상주시 공성면,5076,2193,2429,2647
4725036000,47250360,3708036,경상북도 상주시 외남면,1892,824,947,945
4725037000,47250370,3708037,경상북도 상주시 내서면,2129,907,1037,1092
4725038000,47250380,3708038,경상북도 상주시 모동면,2857,1240,1437,1420
4725039000,47250390,3708039,경상북도 상주시 모서면,2707,1209,1340,1367
4725040000,47250400,3708040,경상북도 상주시 화동면,2229,938,1102,1127
4725041000,47250410,3708041,경상북도 상주시 화서면,2945,1290,1439,1506
4725042000,47250420,3708042,경상북도 상주시 화북면,1665,736,830,835
4725043000,47250430,3708043,경상북도 상주시 외서면,2954,1334,1427,1527
4725044000,47250440,3708044,경상북도 상주시 은척면,1807,883,880,927
4725045000,47250450,3708045,경상북도 상주시 공검면,2675,1234,1276,1399
4725046000,47250460,3708046,경상북도 상주시 이안면,2437,1140,1175,1262
4725047000,47250470,3708047,경상북도 상주시 화남면,883,439,421,462
4725052000,47250520,3708052,경상북도 상주시 남원동,12437,4673,6181,6256
4725053000,47250530,3708053,경상북도 상주시 북문동,6347,2517,3175,3172
4725054000,47250540,3708054,경상북도 상주시 계림동,8494,3481,4174,4320
4725055000,47250550,3708055,경상북도 상주시 동문동,10221,3971,5065,5156
4725056000,47250560,3708056,경상북도 상주시 동성동,4453,1759,2193,2260
4725057000,47250570,3708057,경상북도 상주시 신흥동,9678,3371,4807,4871
4728000000,47280000,#N/A,경상북도 문경시 ,74333,30435,36791,37542
4728025000,47280250,3709011,경상북도 문경시 문경읍,7535,3190,3683,3852
4728025300,47280253,3709012,경상북도 문경시 가은읍,4282,2045,2104,2178
4728031000,47280310,3709031,경상북도 문경시 영순면,2660,1166,1306,1354
4728032000,47280320,3709032,경상북도 문경시 산양면,3627,1625,1810,1817
4728033000,47280330,3709033,경상북도 문경시 호계면,2554,1107,1275,1279
4728034000,47280340,3709034,경상북도 문경시 산북면,3094,1463,1522,1572
4728035000,47280350,3709035,경상북도 문경시 동로면,1686,839,830,856
4728036000,47280360,3709036,경상북도 문경시 마성면,4021,1897,1974,2047
4728037000,47280370,3709037,경상북도 문경시 농암면,2730,1344,1282,1448
4728057000,47280570,3709057,경상북도 문경시 점촌1동,6637,2613,3317,3320
4728058000,47280580,3709058,경상북도 문경시 점촌2동,8388,3368,4163,4225
4728059000,47280590,3709059,경상북도 문경시 점촌3동,9894,3606,5022,4872
4728060000,47280600,3709060,경상북도 문경시 점촌4동,3821,1662,1917,1904
4728061000,47280610,3709061,경상북도 문경시 점촌5동,13404,4510,6586,6818
4729000000,47290000,#N/A,경상북도 경산시 ,237421,90729,119752,117669
4729025000,47290250,3710011,경상북도 경산시 하양읍,29028,10588,14459,14569
4729025300,47290253,3710012,경상북도 경산시 진량읍,38562,14459,19741,18821
4729031000,47290310,3710031,경상북도 경산시 와촌면,6555,2642,3449,3106
4729033000,47290330,3710032,경상북도 경산시 자인면,6820,2828,3533,3287
4729034000,47290340,3710033,경상북도 경산시 용성면,3982,1750,2045,1937
4729035000,47290350,3710034,경상북도 경산시 남산면,4166,1764,2217,1949
4729036000,47290360,3710035,경상북도 경산시 압량면,12537,5106,6533,6004
4729037000,47290370,3710036,경상북도 경산시 남천면,3745,1501,1899,1846
4729051000,47290510,3710056,경상북도 경산시 중방동,7345,2953,3608,3737
4729052000,47290520,3710051,경상북도 경산시 중앙동,7689,3150,3838,3851
4729053000,47290530,3710054,경상북도 경산시 남부동,17727,6572,8719,9008
4729054100,47290541,3710053,경상북도 경산시 서부1동,37665,13375,18476,19189
4729054200,47290542,3710057,경상북도 경산시 서부2동,21136,7207,10482,10654
4729055000,47290550,3710055,경상북도 경산시 북부동,13014,6589,6952,6062
4729056000,47290560,3710052,경상북도 경산시 동부동,27450,10245,13801,13649
4772000000,47720000,#N/A,경상북도 군위군 ,25439,11644,12786,12653
4772025000,47720250,3731011,경상북도 군위군 군위읍,8075,3361,4160,3915
4772031000,47720310,3731031,경상북도 군위군 소보면,2705,1320,1348,1357
4772032000,47720320,3731032,경상북도 군위군 효령면,4202,1918,2170,2032
4772033000,47720330,3731033,경상북도 군위군 부계면,2300,1063,1126,1174
4772034000,47720340,3731034,경상북도 군위군 우보면,2215,1109,1075,1140
4772035000,47720350,3731035,경상북도 군위군 의흥면,2929,1381,1417,1512
4772036000,47720360,3731036,경상북도 군위군 산성면,1444,725,690,754
4772037000,47720370,3731037,경상북도 군위군 고로면,1569,767,800,769
4773000000,47730000,#N/A,경상북도 의성군 ,60152,26794,29650,30502
4773025000,47730250,3732011,경상북도 의성군 의성읍,14855,5845,7359,7496
4773031000,47730310,3732031,경상북도 의성군 단촌면,2395,1102,1199,1196
4773032000,47730320,3732032,경상북도 의성군 점곡면,2015,962,992,1023
4773033000,47730330,3732033,경상북도 의성군 옥산면,2225,974,1104,1121
4773034000,47730340,3732034,경상북도 의성군 사곡면,1846,888,903,943
4773035000,47730350,3732035,경상북도 의성군 춘산면,1755,767,879,876
4773036000,47730360,3732036,경상북도 의성군 가음면,1700,794,832,868
4773037000,47730370,3732037,경상북도 의성군 금성면,5159,2369,2562,2597
4773038000,47730380,3732038,경상북도 의성군 봉양면,4260,1904,2088,2172
4773039000,47730390,3732039,경상북도 의성군 비안면,2818,1360,1383,1435
4773040000,47730400,3732040,경상북도 의성군 구천면,2080,982,1017,1063
4773041000,47730410,3732041,경상북도 의성군 단밀면,2223,1009,1119,1104
4773042000,47730420,3732042,경상북도 의성군 단북면,2220,1023,1104,1116
4773043000,47730430,3732043,경상북도 의성군 안계면,5208,2280,2501,2707
4773044000,47730440,3732044,경상북도 의성군 다인면,4936,2270,2438,2498
4773045000,47730450,3732045,경상북도 의성군 신평면,930,478,455,475
4773046000,47730460,3732046,경상북도 의성군 안평면,2480,1200,1220,1260
4773047000,47730470,3732047,경상북도 의성군 안사면,1047,587,495,552
4775000000,47750000,#N/A,경상북도 청송군 ,27387,12527,13592,13795
4775025000,47750250,3733011,경상북도 청송군 청송읍,5718,2372,2842,2876
4775031000,47750310,3733031,경상북도 청송군 부동면,2033,978,992,1041
4775032000,47750320,3733032,경상북도 청송군 부남면,2560,1265,1280,1280
4775033000,47750330,3733033,경상북도 청송군 현동면,2099,968,1021,1078
4775034000,47750340,3733034,경상북도 청송군 현서면,2691,1293,1326,1365
4775035000,47750350,3733035,경상북도 청송군 안덕면,2845,1403,1392,1453
4775036000,47750360,3733036,경상북도 청송군 파천면,2034,958,1029,1005
4775037000,47750370,3733037,경상북도 청송군 진보면,7407,3290,3710,3697
4776000000,47760000,#N/A,경상북도 영양군 ,18758,8441,9265,9493
4776025000,47760250,3734011,경상북도 영양군 영양읍,8038,3280,3959,4079
4776031000,47760310,3734031,경상북도 영양군 입암면,2588,1229,1267,1321
4776032000,47760320,3734032,경상북도 영양군 청기면,1937,955,963,974
4776033000,47760330,3734033,경상북도 영양군 일월면,1951,909,931,1020
4776034000,47760340,3734034,경상북도 영양군 수비면,1878,915,942,936
4776035000,47760350,3734035,경상북도 영양군 석보면,2366,1153,1203,1163
4777000000,47770000,#N/A,경상북도 영덕군 ,42975,19753,20421,22554
4777025000,47770250,3735011,경상북도 영덕군 영덕읍,11603,4920,5525,6078
4777031000,47770310,3735031,경상북도 영덕군 강구면,8056,3582,3904,4152
4777032000,47770320,3735032,경상북도 영덕군 남정면,2999,1459,1412,1587
4777033000,47770330,3735033,경상북도 영덕군 달산면,1398,702,632,766
4777034000,47770340,3735034,경상북도 영덕군 지품면,2555,1291,1249,1306
4777035000,47770350,3735035,경상북도 영덕군 축산면,3368,1632,1615,1753
4777036000,47770360,3735036,경상북도 영덕군 영해면,7522,3403,3544,3978
4777037000,47770370,3735037,경상북도 영덕군 병곡면,3462,1723,1595,1867
4777038000,47770380,3735038,경상북도 영덕군 창수면,2012,1041,945,1067
4782000000,47820000,#N/A,경상북도 청도군 ,44830,19439,21795,23035
4782025000,47820250,3736011,경상북도 청도군 화양읍,7224,2840,3551,3673
4782025300,47820253,3736012,경상북도 청도군 청도읍,13578,5443,6584,6994
4782031000,47820310,3736031,경상북도 청도군 각남면,2373,1118,1119,1254
4782032000,47820320,3736032,경상북도 청도군 풍각면,4376,2039,2172,2204
4782033000,47820330,3736033,경상북도 청도군 각북면,2221,1081,1092,1129
4782034000,47820340,3736034,경상북도 청도군 이서면,4746,2078,2333,2413
4782035000,47820350,3736035,경상북도 청도군 운문면,2396,1167,1079,1317
4782036000,47820360,3736036,경상북도 청도군 금천면,3784,1752,1884,1900
4782037000,47820370,3736037,경상북도 청도군 매전면,4132,1921,1981,2151
4783000000,47830000,#N/A,경상북도 고령군 ,34863,14933,17768,17095
4783025000,47830250,3737011,경상북도 고령군 고령읍,10408,4367,5229,5179
4783031000,47830310,3737031,경상북도 고령군 덕곡면,1535,747,748,787
4783032000,47830320,3737032,경상북도 고령군 운수면,2231,1057,1122,1109
4783033000,47830330,3737033,경상북도 고령군 성산면,3029,1290,1554,1475
4783034000,47830340,3737034,경상북도 고령군 다산면,8988,3525,4717,4271
4783035000,47830350,3737035,경상북도 고령군 개진면,2299,1083,1195,1104
4783036000,47830360,3737036,경상북도 고령군 우곡면,2048,935,1043,1005
4783037000,47830370,3737037,경상북도 고령군 쌍림면,4325,1929,2160,2165
4784000000,47840000,#N/A,경상북도 성주군 ,45080,19255,23023,22057
4784025000,47840250,3738011,경상북도 성주군 성주읍,13366,5204,6710,6656
4784031000,47840310,3738031,경상북도 성주군 선남면,6622,2813,3485,3137
4784032000,47840320,3738032,경상북도 성주군 용암면,3785,1707,1981,1804
4784033000,47840330,3738033,경상북도 성주군 수륜면,3284,1564,1590,1694
4784034000,47840340,3738034,경상북도 성주군 가천면,2019,956,994,1025
4784035000,47840350,3738035,경상북도 성주군 금수면,1150,599,562,588
4784036000,47840360,3738036,경상북도 성주군 대가면,2545,1142,1292,1253
4784037000,47840370,3738037,경상북도 성주군 벽진면,3585,1529,1853,1732
4784038000,47840380,3738038,경상북도 성주군 초전면,5253,2163,2750,2503
4784039000,47840390,3738039,경상북도 성주군 월항면,3471,1578,1806,1665
4785000000,47850000,#N/A,경상북도 칠곡군 ,116266,46689,59886,56380
4785025000,47850250,3739011,경상북도 칠곡군 왜관읍,32130,12013,16139,15991
4785025300,47850253,3739012,경상북도 칠곡군 북삼읍,25007,8865,12801,12206
4785025600,47850256,3739013,경상북도 칠곡군 석적읍,26074,12146,13785,12289
4785031000,47850310,3739031,경상북도 칠곡군 지천면,5589,2534,2909,2680
4785032000,47850320,3739032,경상북도 칠곡군 동명면,6383,2774,3314,3069
4785033000,47850330,3739033,경상북도 칠곡군 가산면,4131,1827,2207,1924
4785036000,47850360,3739036,경상북도 칠곡군 약목면,14167,5346,7258,6909
4785037000,47850370,3739037,경상북도 칠곡군 기산면,2785,1184,1473,1312
4790000000,47900000,#N/A,경상북도 예천군 ,48231,21067,23882,24349
4790025000,47900250,3740011,경상북도 예천군 예천읍,17643,6990,8837,8806
4790031000,47900310,3740031,경상북도 예천군 용문면,2756,1350,1374,1382
4790032000,47900320,3740032,경상북도 예천군 상리면,1291,601,627,664
4790033000,47900330,3740033,경상북도 예천군 하리면,1611,714,805,806
4790034000,47900340,3740034,경상북도 예천군 감천면,3257,1506,1629,1628
4790035000,47900350,3740035,경상북도 예천군 보문면,1965,958,957,1008
4790036000,47900360,3740036,경상북도 예천군 호명면,3016,1381,1472,1544
4790037000,47900370,3740037,경상북도 예천군 유천면,3390,1494,1691,1699
4790038000,47900380,3740038,경상북도 예천군 용궁면,3312,1504,1638,1674
4790039000,47900390,3740039,경상북도 예천군 개포면,2054,963,1000,1054
4790040000,47900400,3740040,경상북도 예천군 지보면,3547,1688,1754,1793
4790041000,47900410,3740041,경상북도 예천군 풍양면,4389,1918,2098,2291
4792000000,47920000,#N/A,경상북도 봉화군 ,34688,15254,17378,17310
4792025000,47920250,3741011,경상북도 봉화군 봉화읍,10881,4345,5406,5475
4792031000,47920310,3741031,경상북도 봉화군 물야면,3410,1551,1687,1723
4792032000,47920320,3741032,경상북도 봉화군 봉성면,2507,1077,1232,1275
4792033000,47920330,3741033,경상북도 봉화군 법전면,2294,1079,1136,1158
4792034000,47920340,3741034,경상북도 봉화군 춘양면,5024,2243,2503,2521
4792035000,47920350,3741035,경상북도 봉화군 소천면,2434,1191,1234,1200
4792036000,47920360,3741037,경상북도 봉화군 재산면,1689,821,852,837
4792037000,47920370,3741038,경상북도 봉화군 명호면,2384,1084,1233,1151
4792038000,47920380,3741039,경상북도 봉화군 상운면,1967,919,987,980
4792039000,47920390,3741036,경상북도 봉화군 석포면,2098,944,1108,990
4793000000,47930000,#N/A,경상북도 울진군 ,53060,23055,26111,26949
4793025000,47930250,3742011,경상북도 울진군 울진읍,13328,5027,6605,6723
4793025300,47930253,3742012,경상북도 울진군 평해읍,3566,1653,1707,1859
4793031000,47930310,3742031,경상북도 울진군 북면,7430,3070,3825,3605
4793032000,47930320,3742032,경상북도 울진군 서면,1686,870,786,900
4793033000,47930330,3742033,경상북도 울진군 근남면,3132,1499,1492,1640
4793034000,47930340,3742034,경상북도 울진군 원남면,2646,1360,1263,1383
4793035000,47930350,3742035,경상북도 울진군 기성면,3131,1625,1453,1678
4793036000,47930360,3742036,경상북도 울진군 온정면,2261,1071,1088,1173
4793037000,47930370,3742037,경상북도 울진군 죽변면,7082,3100,3554,3528
4793038000,47930380,3742038,경상북도 울진군 후포면,8798,3780,4338,4460
4794000000,47940000,#N/A,경상북도 울릉군 ,10254,4620,5331,4923
4794025000,47940250,3743011,경상북도 울릉군 울릉읍,7324,3262,3788,3536
4794031000,47940310,3743031,경상북도 울릉군 서면,1581,725,837,744
4794032000,47940320,3743032,경상북도 울릉군 북면,1349,633,706,643
4800000000,48000000,#N/A,경상남도  ,3218292,1199856,1618395,1599897
4811000000,48110000,#N/A,경상남도 창원시 ,504455,174511,257653,246802
4811025000,48110250,3801011,경상남도 창원시 동읍,24226,8439,12275,11951
4811032000,48110320,3801031,경상남도 창원시 북면,12307,4642,6253,6054
4811033000,48110330,3801032,경상남도 창원시 대산면,8149,3259,4104,4045
4811052500,48110525,3801051,경상남도 창원시 의창동,38551,13476,19567,18984
4811054000,48110540,3801052,경상남도 창원시 팔룡동,43984,14516,22678,21306
4811054500,48110545,3801053,경상남도 창원시 명곡동,51275,17894,26091,25184
4811055700,48110557,3801054,경상남도 창원시 봉림동,35474,14834,18438,17036
4811057500,48110575,3801055,경상남도 창원시 반송동,51630,16323,26289,25341
4811060500,48110605,3801057,경상남도 창원시 용지동,38185,13800,19055,19130
4811061600,48110616,3801059,경상남도 창원시 사파동,58901,18855,29859,29042
4811061800,48110618,3801058,경상남도 창원시 상남동,34930,10720,17609,17321
4811062000,48110620,3801056,경상남도 창원시 중앙동,22016,9951,11529,10487
4811063000,48110630,3801060,경상남도 창원시 가음정동,47891,15630,24461,23430
4811065000,48110650,3801061,경상남도 창원시 성주동,26719,8464,14040,12679
4811067500,48110675,3801062,경상남도 창원시 웅남동,10217,3708,5405,4812
4816000000,48160000,#N/A,경상남도 마산시 ,411963,150613,207433,204530
4816025000,48160250,3802011,경상남도 마산시 내서읍,74610,23417,37421,37189
4816031000,48160310,3802031,경상남도 마산시 구산면,5560,2396,2830,2730
4816032000,48160320,3802032,경상남도 마산시 진동면,9120,3389,4706,4414
4816033000,48160330,3802033,경상남도 마산시 진북면,4553,1822,2360,2193
4816034000,48160340,3802034,경상남도 마산시 진전면,4629,2121,2300,2329
4816051000,48160510,3802051,경상남도 마산시 현동,2478,930,1306,1172
4816052000,48160520,3802052,경상남도 마산시 가포동,1923,791,981,942
4816053000,48160530,3802053,경상남도 마산시 월영동,35468,11727,17703,17765
4816054000,48160540,3802054,경상남도 마산시 문화동,14281,5527,7109,7172
4816055000,48160550,3802055,경상남도 마산시 반월동,9746,3388,4850,4896
4816056000,48160560,3802056,경상남도 마산시 중앙동,9236,3245,4510,4726
4816057000,48160570,3802057,경상남도 마산시 완월동,12674,4354,6303,6371
4816058000,48160580,3802058,경상남도 마산시 자산동,15123,5316,7525,7598
4816059000,48160590,3802059,경상남도 마산시 동서동,9506,3857,4708,4798
4816060000,48160600,3802060,경상남도 마산시 성호동,5279,2105,2673,2606
4816061000,48160610,3802061,경상남도 마산시 교방동,10062,3759,4979,5083
4816062000,48160620,3802062,경상남도 마산시 노산동,6569,2860,3304,3265
4816063000,48160630,3802063,경상남도 마산시 오동동,4950,2486,2435,2515
4816064000,48160640,3802064,경상남도 마산시 합포동,8789,3619,4432,4357
4816065000,48160650,3802065,경상남도 마산시 산호동,16040,6349,8003,8037
4816066000,48160660,3802066,경상남도 마산시 회원1동,13872,5432,6973,6899
4816067000,48160670,3802067,경상남도 마산시 회원2동,16049,5973,8068,7981
4816068000,48160680,3802068,경상남도 마산시 석전1동,9422,3451,4810,4612
4816069000,48160690,3802069,경상남도 마산시 석전2동,10293,3882,5193,5100
4816070000,48160700,3802070,경상남도 마산시 회성동,9257,3483,4804,4453
4816071000,48160710,3802071,경상남도 마산시 양덕1동,14184,5500,7140,7044
4816072000,48160720,3802072,경상남도 마산시 양덕2동,24521,8595,12457,12064
4816073000,48160730,3802073,경상남도 마산시 합성1동,11595,4583,5959,5636
4816074000,48160740,3802074,경상남도 마산시 합성2동,11237,4677,5636,5601
4816075000,48160750,3802075,경상남도 마산시 구암1동,13343,4853,6876,6467
4816076000,48160760,3802076,경상남도 마산시 구암2동,12495,4558,6345,6150
4816077000,48160770,3802077,경상남도 마산시 봉암동,5099,2168,2734,2365
4817000000,48170000,#N/A,경상남도 진주시 ,331811,122421,164609,167202
4817025000,48170250,3803011,경상남도 진주시 문산읍,7697,2954,3796,3901
4817031000,48170310,3803031,경상남도 진주시 내동면,1743,764,879,864
4817032000,48170320,3803032,경상남도 진주시 정촌면,3417,1363,1739,1678
4817033000,48170330,3803033,경상남도 진주시 금곡면,2806,1234,1353,1453
4817035000,48170350,3803034,경상남도 진주시 진성면,2549,1110,1242,1307
4817036000,48170360,3803035,경상남도 진주시 일반성면,3420,1387,1667,1753
4817037000,48170370,3803036,경상남도 진주시 이반성면,2007,996,980,1027
4817038000,48170380,3803037,경상남도 진주시 사봉면,1944,926,946,998
4817039000,48170390,3803038,경상남도 진주시 지수면,1968,919,965,1003
4817040000,48170400,3803039,경상남도 진주시 대곡면,4346,1887,2154,2192
4817041000,48170410,3803040,경상남도 진주시 금산면,18844,6043,9522,9322
4817042000,48170420,3803041,경상남도 진주시 집현면,5986,2101,3053,2933
4817043000,48170430,3803042,경상남도 진주시 미천면,2081,975,1038,1043
4817044000,48170440,3803043,경상남도 진주시 명석면,5097,2103,2613,2484
4817045000,48170450,3803044,경상남도 진주시 대평면,1251,499,610,641
4817046000,48170460,3803045,경상남도 진주시 수곡면,2520,1124,1266,1254
4817051000,48170510,3803051,경상남도 진주시 망경동,18394,6333,9225,9169
4817052000,48170520,3803052,경상남도 진주시 강남동,6519,2567,3227,3292
4817053000,48170530,3803053,경상남도 진주시 칠암동,11468,4341,5648,5820
4817054500,48170545,3803054,경상남도 진주시 성지동,6673,2838,3262,3411
4817056500,48170565,3803055,경상남도 진주시 중앙동,4533,2144,2147,2386
4817057500,48170575,3803056,경상남도 진주시 봉안동,6940,3130,3375,3565
4817059000,48170590,3803057,경상남도 진주시 상봉동동,7882,3247,3877,4005
4817060000,48170600,3803058,경상남도 진주시 상봉서동,11395,4290,5564,5831
4817061500,48170615,3803059,경상남도 진주시 봉수동,5222,2139,2626,2596
4817064500,48170645,3803060,경상남도 진주시 옥봉동,7438,3112,3677,3761
4817066000,48170660,3803061,경상남도 진주시 상대1동,15280,5826,7592,7688
4817067000,48170670,3803062,경상남도 진주시 상대2동,13419,5017,6619,6800
4817067600,48170676,3803063,경상남도 진주시 하대1동,16846,5557,8347,8499
4817067700,48170677,3803064,경상남도 진주시 하대2동,14507,4501,7214,7293
4817068000,48170680,3803065,경상남도 진주시 상평동,12935,4973,6631,6304
4817069500,48170695,3803066,경상남도 진주시 초장동,9974,3066,5177,4797
4817071000,48170710,3803067,경상남도 진주시 평거동,30568,10069,14853,15715
4817071500,48170715,3803068,경상남도 진주시 신안동,15934,5528,7759,8175
4817072000,48170720,3803069,경상남도 진주시 이현동,16301,5683,8202,8099
4817073000,48170730,3803070,경상남도 진주시 판문동,10754,3696,5213,5541
4817074000,48170740,3803071,경상남도 진주시 가호동,21153,7979,10551,10602
4819000000,48190000,#N/A,경상남도 진해시 ,167509,60938,85113,82396
4819051500,48190515,3804051,경상남도 진해시 중앙동,4978,1794,2516,2462
4819052500,48190525,3804052,경상남도 진해시 태평동,7475,2862,3896,3579
4819055500,48190555,3804053,경상남도 진해시 충무동,5251,2190,2665,2586
4819057500,48190575,3804054,경상남도 진해시 여좌동,13469,5332,6787,6682
4819060000,48190600,3804055,경상남도 진해시 태백동,7711,3242,3931,3780
4819061500,48190615,3804056,경상남도 진해시 경화동,12136,4327,6186,5950
4819063500,48190635,3804057,경상남도 진해시 병암동,7796,2923,3900,3896
4819064000,48190640,3804058,경상남도 진해시 석동,15483,4949,7777,7706
4819065000,48190650,3804059,경상남도 진해시 이동,11373,4470,5834,5539
4819066000,48190660,3804060,경상남도 진해시 자은동,12531,4287,6318,6213
4819067000,48190670,3804061,경상남도 진해시 덕산동,11825,3979,5853,5972
4819068000,48190680,3804062,경상남도 진해시 풍호동,16370,5226,8164,8206
4819071500,48190715,3804064,경상남도 진해시 웅천동,5228,2211,2773,2455
4819073000,48190730,3804065,경상남도 진해시 웅동1동,6616,2557,3400,3216
4819074000,48190740,3804066,경상남도 진해시 웅동2동,29267,10589,15113,14154
4822000000,48220000,#N/A,경상남도 통영시 ,136039,53164,69315,66724
4822025000,48220250,3805011,경상남도 통영시 산양읍,5938,2546,3102,2836
4822031000,48220310,3805031,경상남도 통영시 용남면,10848,3786,5505,5343
4822033000,48220330,3805032,경상남도 통영시 도산면,3490,1508,1797,1693
4822034000,48220340,3805033,경상남도 통영시 광도면,16978,6575,8809,8169
4822035000,48220350,3805034,경상남도 통영시 욕지면,2317,1167,1210,1107
4822036000,48220360,3805035,경상남도 통영시 한산면,2597,1251,1312,1285
4822037000,48220370,3805036,경상남도 통영시 사량면,1875,925,906,969
4822051000,48220510,3805051,경상남도 통영시 도천동,7660,3063,3836,3824
4822053000,48220530,3805052,경상남도 통영시 명정동,5100,2195,2610,2490
4822055000,48220550,3805053,경상남도 통영시 중앙동,7351,3251,3697,3654
4822059000,48220590,3805054,경상남도 통영시 정량동,12345,5004,6387,5958
4822060000,48220600,3805055,경상남도 통영시 북신동,12640,4558,6281,6359
4822063000,48220630,3805057,경상남도 통영시 인평동,5509,2034,2844,2665
4822065000,48220650,3805058,경상남도 통영시 미수1동,6979,2406,3529,3450
4822066000,48220660,3805059,경상남도 통영시 미수2동,5897,2032,2967,2930
4822067000,48220670,3805060,경상남도 통영시 봉평동,6453,2603,3335,3118
4822069500,48220695,3805061,경상남도 통영시 도남동,7897,3324,4133,3764
4822070000,48220700,3805056,경상남도 통영시 무전동,14165,4936,7055,7110
4824000000,48240000,#N/A,경상남도 사천시 ,113015,45106,56833,56182
4824025000,48240250,3806011,경상남도 사천시 사천읍,16991,6710,8586,8405
4824031000,48240310,3806031,경상남도 사천시 정동면,11908,4197,6009,5899
4824032000,48240320,3806032,경상남도 사천시 사남면,10040,4018,5089,4951
4824033000,48240330,3806033,경상남도 사천시 용현면,6099,2596,3112,2987
4824034000,48240340,3806034,경상남도 사천시 축동면,2185,977,1132,1053
4824035000,48240350,3806035,경상남도 사천시 곤양면,4754,2037,2363,2391
4824036000,48240360,3806036,경상남도 사천시 곤명면,3400,1567,1703,1697
4824037000,48240370,3806037,경상남도 사천시 서포면,4518,1962,2259,2259
4824051000,48240510,3806051,경상남도 사천시 동서동,9013,3756,4578,4435
4824052000,48240520,3806052,경상남도 사천시 선구동,7536,3139,3765,3771
4824053000,48240530,3806053,경상남도 사천시 동서금동,6776,2956,3327,3449
4824055000,48240550,3806055,경상남도 사천시 벌용동,16404,6067,8085,8319
4824057000,48240570,3806057,경상남도 사천시 향촌동,7023,2630,3688,3335
4824059500,48240595,3806059,경상남도 사천시 남양동,6368,2494,3137,3231
4825000000,48250000,#N/A,경상남도 김해시 ,475081,162754,239268,235813
4825025000,48250250,3807011,경상남도 김해시 진영읍,34252,12467,17371,16881
4825031000,48250310,3807031,경상남도 김해시 장유면,100505,32307,50168,50337
4825032000,48250320,3807032,경상남도 김해시 주촌면,4419,1857,2382,2037
4825033000,48250330,3807033,경상남도 김해시 진례면,8272,3343,4352,3920
4825034000,48250340,3807034,경상남도 김해시 한림면,10357,4458,5507,4850
4825035000,48250350,3807035,경상남도 김해시 생림면,4824,2186,2501,2323
4825036000,48250360,3807036,경상남도 김해시 상동면,3924,1679,2095,1829
4825037000,48250370,3807037,경상남도 김해시 대동면,8390,3268,4369,4021
4825051000,48250510,3807051,경상남도 김해시 동상동,9646,3663,4811,4835
4825052000,48250520,3807052,경상남도 김해시 회현동,9913,3966,5034,4879
4825053000,48250530,3807053,경상남도 김해시 부원동,7681,3211,3896,3785
4825054000,48250540,3807054,경상남도 김해시 내외동,88634,29238,44132,44502
4825055000,48250550,3807055,경상남도 김해시 북부동,74230,23735,36994,37236
4825056500,48250565,3807056,경상남도 김해시 칠산서부동,9608,3369,4882,4726
4825058000,48250580,3807058,경상남도 김해시 활천동,45874,15248,23250,22624
4825059000,48250590,3807059,경상남도 김해시 삼안동,45188,15569,22799,22389
4825060000,48250600,3807060,경상남도 김해시 불암동,9364,3190,4725,4639
4827000000,48270000,#N/A,경상남도 밀양시 ,110902,44984,54396,56506
4827025000,48270250,3808011,경상남도 밀양시 삼랑진읍,7959,3401,3968,3991
4827025300,48270253,3808012,경상남도 밀양시 하남읍,9063,3768,4470,4593
4827031000,48270310,3808031,경상남도 밀양시 부북면,6747,2777,3355,3392
4827032000,48270320,3808032,경상남도 밀양시 상동면,3197,1520,1518,1679
4827033000,48270330,3808033,경상남도 밀양시 산외면,3017,1294,1516,1501
4827034000,48270340,3808034,경상남도 밀양시 산내면,4002,1748,1981,2021
4827035000,48270350,3808035,경상남도 밀양시 단장면,4284,1910,2081,2203
4827036000,48270360,3808036,경상남도 밀양시 상남면,10723,4185,5297,5426
4827037000,48270370,3808037,경상남도 밀양시 초동면,3648,1763,1813,1835
4827038000,48270380,3808038,경상남도 밀양시 무안면,6150,2755,2968,3182
4827039000,48270390,3808039,경상남도 밀양시 청도면,1994,943,994,1000
4827051000,48270510,3808051,경상남도 밀양시 내일동,4519,1891,2178,2341
4827052000,48270520,3808052,경상남도 밀양시 내이동,10636,4219,5219,5417
4827053000,48270530,3808054,경상남도 밀양시 삼문동,18102,6249,8836,9266
4827054000,48270540,3808055,경상남도 밀양시 가곡동,9327,3877,4432,4895
4827055000,48270550,3808053,경상남도 밀양시 교동,7534,2684,3770,3764
4831000000,48310000,#N/A,경상남도 거제시 ,215891,78839,112811,103080
4831031000,48310310,3809031,경상남도 거제시 일운면,6231,2460,3189,3042
4831032000,48310320,3809032,경상남도 거제시 동부면,3658,1562,1883,1775
4831033000,48310330,3809033,경상남도 거제시 남부면,1883,850,962,921
4831034000,48310340,3809034,경상남도 거제시 거제면,7091,2781,3499,3592
4831035000,48310350,3809035,경상남도 거제시 둔덕면,3656,1546,1873,1783
4831036000,48310360,3809036,경상남도 거제시 사등면,8372,3525,4353,4019
4831037000,48310370,3809037,경상남도 거제시 연초면,8822,3835,4741,4081
4831038000,48310380,3809038,경상남도 거제시 하청면,4893,2078,2507,2386
4831039000,48310390,3809039,경상남도 거제시 장목면,5432,2303,2735,2697
4831051000,48310510,3809051,경상남도 거제시 장승포동,3726,1508,2039,1687
4831052000,48310520,3809052,경상남도 거제시 마전동,5726,2332,3201,2525
4831053000,48310530,3809053,경상남도 거제시 능포동,12897,4581,6817,6080
4831054000,48310540,3809054,경상남도 거제시 아주동,8633,3134,4734,3899
4831055000,48310550,3809055,경상남도 거제시 옥포1동,9113,3573,4805,4308
4831056000,48310560,3809056,경상남도 거제시 옥포2동,30025,9959,15463,14562
4831057000,48310570,3809057,경상남도 거제시 장평동,26517,9886,14449,12068
4831058000,48310580,3809058,경상남도 거제시 고현동,40250,13690,20526,19724
4831059000,48310590,3809059,경상남도 거제시 상문동,20862,6567,10816,10046
4831060000,48310600,3809060,경상남도 거제시 수양동,8104,2669,4219,3885
4833000000,48330000,#N/A,경상남도 양산시 ,241453,86621,121833,119620
4833025300,48330253,3810012,경상남도 양산시 물금읍,36693,12319,18344,18349
4833031000,48330310,3810031,경상남도 양산시 동면,12561,4527,6407,6154
4833032000,48330320,3810032,경상남도 양산시 원동면,3906,1855,1949,1957
4833033000,48330330,3810033,경상남도 양산시 상북면,15535,5713,7932,7603
4833034000,48330340,3810034,경상남도 양산시 하북면,10067,4168,5182,4885
4833051000,48330510,3810051,경상남도 양산시 중앙동,50359,17515,25101,25258
4833052000,48330520,3810052,경상남도 양산시 삼성동,24041,8723,12350,11691
4833053000,48330530,3810053,경상남도 양산시 강서동,8350,3029,4305,4045
4833054000,48330540,3810054,경상남도 양산시 서창동,24370,9082,12288,12082
4833055000,48330550,3810055,경상남도 양산시 소주동,17886,6651,9055,8831
4833056000,48330560,3810056,경상남도 양산시 평산동,25222,8598,12651,12571
4833057000,48330570,3810057,경상남도 양산시 덕계동,12463,4441,6269,6194
4872000000,48720000,#N/A,경상남도 의령군 ,30222,13893,14499,15723
4872025000,48720250,3831011,경상남도 의령군 의령읍,9258,3681,4573,4685
4872031000,48720310,3831031,경상남도 의령군 가례면,2190,931,1054,1136
4872032000,48720320,3831032,경상남도 의령군 칠곡면,1283,615,610,673
4872033000,48720330,3831033,경상남도 의령군 대의면,1206,617,559,647
4872034000,48720340,3831034,경상남도 의령군 화정면,1714,831,833,881
4872035000,48720350,3831035,경상남도 의령군 용덕면,1881,859,895,986
4872036000,48720360,3831036,경상남도 의령군 정곡면,1728,864,832,896
4872037000,48720370,3831037,경상남도 의령군 지정면,2204,1077,1096,1108
4872038000,48720380,3831038,경상남도 의령군 낙서면,1026,501,480,546
4872039000,48720390,3831039,경상남도 의령군 부림면,3615,1693,1693,1922
4872040000,48720400,3831040,경상남도 의령군 봉수면,1197,640,560,637
4872041500,48720415,3831041,경상남도 의령군 궁류면,1409,789,636,773
4872042000,48720420,3831042,경상남도 의령군 유곡면,1511,795,678,833
4873000000,48730000,#N/A,경상남도 함안군 ,66043,26969,33266,32777
4873025000,48730250,3832011,경상남도 함안군 가야읍,18108,6851,9077,9031
4873031000,48730310,3832031,경상남도 함안군 함안면,2918,1351,1431,1487
4873032000,48730320,3832032,경상남도 함안군 군북면,7179,3290,3606,3573
4873033000,48730330,3832033,경상남도 함안군 법수면,3376,1575,1695,1681
4873034000,48730340,3832034,경상남도 함안군 대산면,4514,2057,2293,2221
4873035000,48730350,3832035,경상남도 함안군 칠서면,6005,2555,3038,2967
4873036000,48730360,3832036,경상남도 함안군 칠북면,2398,1161,1227,1171
4873037000,48730370,3832037,경상남도 함안군 칠원읍,17708,6281,8994,8714
4873038000,48730380,3832038,경상남도 함안군 산인면,2916,1413,1466,1450
4873039000,48730390,3832039,경상남도 함안군 여항면,921,435,439,482
4874000000,48740000,#N/A,경상남도 창녕군 ,61682,27033,30240,31442
4874025000,48740250,3833011,경상남도 창녕군 창녕읍,16810,6641,8218,8592
4874025300,48740253,3833012,경상남도 창녕군 남지읍,10344,4341,5076,5268
4874031000,48740310,3833031,경상남도 창녕군 고암면,2022,1062,968,1054
4874032000,48740320,3833032,경상남도 창녕군 성산면,1553,838,709,844
4874033000,48740330,3833033,경상남도 창녕군 대합면,4125,1969,2049,2076
4874034000,48740340,3833034,경상남도 창녕군 이방면,2972,1354,1456,1516
4874035000,48740350,3833035,경상남도 창녕군 유어면,2049,1011,994,1055
4874036000,48740360,3833036,경상남도 창녕군 대지면,2473,1091,1252,1221
4874037000,48740370,3833037,경상남도 창녕군 계성면,2578,1227,1292,1286
4874038000,48740380,3833038,경상남도 창녕군 영산면,6278,2646,3137,3141
4874039000,48740390,3833039,경상남도 창녕군 장마면,1940,984,931,1009
4874040000,48740400,3833040,경상남도 창녕군 도천면,2937,1345,1401,1536
4874041000,48740410,3833041,경상남도 창녕군 길곡면,1464,688,718,746
4874042000,48740420,3833042,경상남도 창녕군 부곡면,4137,1836,2039,2098
4882000000,48820000,#N/A,경상남도 고성군 ,55656,24057,27754,27902
4882025000,48820250,3834011,경상남도 고성군 고성읍,23712,9412,11847,11865
4882031000,48820310,3834031,경상남도 고성군 삼산면,1944,939,980,964
4882032000,48820320,3834032,경상남도 고성군 하일면,2069,986,989,1080
4882033000,48820330,3834033,경상남도 고성군 하이면,3088,1292,1548,1540
4882034000,48820340,3834034,경상남도 고성군 상리면,1909,932,939,970
4882035000,48820350,3834035,경상남도 고성군 대가면,1798,895,850,948
4882036000,48820360,3834036,경상남도 고성군 영현면,1042,552,499,543
4882037000,48820370,3834037,경상남도 고성군 영오면,1746,787,839,907
4882038000,48820380,3834038,경상남도 고성군 개천면,1394,637,684,710
4882039000,48820390,3834039,경상남도 고성군 구만면,1203,587,559,644
4882040000,48820400,3834040,경상남도 고성군 회화면,4074,1805,1997,2077
4882041000,48820410,3834041,경상남도 고성군 마암면,2217,957,1108,1109
4882042000,48820420,3834042,경상남도 고성군 동해면,4077,1857,2093,1984
4882043000,48820430,3834043,경상남도 고성군 거류면,5383,2419,2822,2561
4884000000,48840000,#N/A,경상남도 남해군 ,50966,22143,24354,26612
4884025000,48840250,3835011,경상남도 남해군 남해읍,13742,5306,6720,7022
4884031000,48840310,3835031,경상남도 남해군 이동면,4817,2205,2326,2491
4884032000,48840320,3835032,경상남도 남해군 상주면,1969,897,931,1038
4884033000,48840330,3835033,경상남도 남해군 삼동면,4657,2115,2244,2413
4884034000,48840340,3835034,경상남도 남해군 미조면,3044,1282,1539,1505
4884035000,48840350,3835035,경상남도 남해군 남면,4518,2189,2086,2432
4884036000,48840360,3835036,경상남도 남해군 서면,3471,1622,1595,1876
4884037000,48840370,3835037,경상남도 남해군 고현면,4763,2030,2215,2548
4884038000,48840380,3835038,경상남도 남해군 설천면,3608,1593,1686,1922
4884039000,48840390,3835039,경상남도 남해군 창선면,6377,2904,3012,3365
4885000000,48850000,#N/A,경상남도 하동군 ,52998,21942,26077,26921
4885025000,48850250,3836011,경상남도 하동군 하동읍,11657,4516,5758,5899
4885031000,48850310,3836031,경상남도 하동군 화개면,3626,1483,1804,1822
4885032000,48850320,3836032,경상남도 하동군 악양면,3846,1736,1859,1987
4885033000,48850330,3836033,경상남도 하동군 적량면,2334,1022,1124,1210
4885034000,48850340,3836034,경상남도 하동군 횡천면,2303,953,1112,1191
4885035000,48850350,3836035,경상남도 하동군 고전면,2894,1198,1400,1494
4885036000,48850360,3836036,경상남도 하동군 금남면,4479,1879,2255,2224
4885037000,48850370,3836038,경상남도 하동군 진교면,7273,2916,3538,3735
4885038000,48850380,3836039,경상남도 하동군 양보면,2299,970,1074,1225
4885039000,48850390,3836040,경상남도 하동군 북천면,2076,981,1021,1055
4885040000,48850400,3836041,경상남도 하동군 청암면,1820,789,927,893
4885041000,48850410,3836042,경상남도 하동군 옥종면,4494,1984,2208,2286
4885042000,48850420,3836037,경상남도 하동군 금성면,3897,1515,1997,1900
4886000000,48860000,#N/A,경상남도 산청군 ,35018,16234,16964,18054
4886025000,48860250,3837011,경상남도 산청군 산청읍,6601,2921,3237,3364
4886031000,48860310,3837031,경상남도 산청군 차황면,1605,782,754,851
4886032000,48860320,3837032,경상남도 산청군 오부면,1160,566,568,592
4886033000,48860330,3837033,경상남도 산청군 생초면,2501,1212,1162,1339
4886034000,48860340,3837034,경상남도 산청군 금서면,2646,1228,1256,1390
4886035000,48860350,3837035,경상남도 산청군 삼장면,1762,827,854,908
4886036000,48860360,3837036,경상남도 산청군 시천면,4028,1795,1966,2062
4886037000,48860370,3837037,경상남도 산청군 단성면,5585,2774,2719,2866
4886038000,48860380,3837038,경상남도 산청군 신안면,5556,2335,2741,2815
4886039000,48860390,3837039,경상남도 산청군 생비량면,1327,684,616,711
4886040000,48860400,3837040,경상남도 산청군 신등면,2247,1110,1091,1156
4887000000,48870000,#N/A,경상남도 함양군 ,40514,17896,19382,21132
4887025000,48870250,3838011,경상남도 함양군 함양읍,17997,6997,8734,9263
4887031000,48870310,3838031,경상남도 함양군 마천면,2313,1171,1096,1217
4887032000,48870320,3838032,경상남도 함양군 휴천면,1593,830,772,821
4887033000,48870330,3838033,경상남도 함양군 유림면,2011,1029,904,1107
4887034000,48870340,3838034,경상남도 함양군 수동면,2798,1283,1320,1478
4887035000,48870350,3838035,경상남도 함양군 지곡면,2131,1009,1014,1117
4887036000,48870360,3838036,경상남도 함양군 안의면,5265,2504,2505,2760
4887037000,48870370,3838037,경상남도 함양군 서하면,1473,710,716,757
4887038000,48870380,3838038,경상남도 함양군 서상면,1984,929,916,1068
4887039000,48870390,3838039,경상남도 함양군 백전면,1525,759,728,797
4887040000,48870400,3838040,경상남도 함양군 병곡면,1424,675,677,747
4888000000,48880000,#N/A,경상남도 거창군 ,63443,25978,30873,32570
4888025000,48880250,3839011,경상남도 거창군 거창읍,39421,14620,19346,20075
4888031000,48880310,3839031,경상남도 거창군 주상면,1782,827,848,934
4888032000,48880320,3839032,경상남도 거창군 웅양면,2118,978,1031,1087
4888033000,48880330,3839033,경상남도 거창군 고제면,1457,706,713,744
4888034000,48880340,3839034,경상남도 거창군 북상면,1595,784,778,817
4888035000,48880350,3839035,경상남도 거창군 위천면,2404,1087,1168,1236
4888036000,48880360,3839036,경상남도 거창군 마리면,2327,1125,1111,1216
4888037000,48880370,3839037,경상남도 거창군 남상면,2834,1292,1365,1469
4888038000,48880380,3839038,경상남도 거창군 남하면,1822,881,854,968
4888039000,48880390,3839039,경상남도 거창군 신원면,1862,928,892,970
4888040000,48880400,3839040,경상남도 거창군 가조면,4348,1968,2062,2286
4888041000,48880410,3839041,경상남도 거창군 가북면,1473,782,705,768
4889000000,48890000,#N/A,경상남도 합천군 ,53631,23760,25722,27909
4889025000,48890250,3840011,경상남도 합천군 합천읍,12761,4660,6228,6533
4889031000,48890310,3840031,경상남도 합천군 봉산면,1760,871,812,948
4889032000,48890320,3840032,경상남도 합천군 묘산면,2047,943,958,1089
4889033000,48890330,3840033,경상남도 합천군 가야면,5490,2218,2805,2685
4889034000,48890340,3840034,경상남도 합천군 야로면,3039,1359,1482,1557
4889035000,48890350,3840035,경상남도 합천군 율곡면,3018,1433,1461,1557
4889036000,48890360,3840036,경상남도 합천군 초계면,3378,1498,1609,1769
4889037000,48890370,3840037,경상남도 합천군 쌍책면,1625,814,759,866
4889038000,48890380,3840038,경상남도 합천군 덕곡면,1031,537,469,562
4889039000,48890390,3840039,경상남도 합천군 청덕면,2017,1043,931,1086
4889040000,48890400,3840040,경상남도 합천군 적중면,1882,924,898,984
4889041000,48890410,3840041,경상남도 합천군 대양면,1869,954,880,989
4889042000,48890420,3840042,경상남도 합천군 쌍백면,2285,1139,1059,1226
4889043000,48890430,3840043,경상남도 합천군 삼가면,4358,1981,1995,2363
4889044000,48890440,3840044,경상남도 합천군 가회면,2089,1050,1011,1078
4889045000,48890450,3840045,경상남도 합천군 대병면,2337,1096,1107,1230
4889046000,48890460,3840046,경상남도 합천군 용주면,2645,1240,1258,1387
5000000000,50000000,#N/A,제주특별자치도  ,560489,214145,280000,280489
5011000000,50110000,#N/A,제주특별자치도 제주시 ,407283,154975,202988,204295
5011025000,50110250,3901011,제주특별자치도 제주시 한림읍,19545,7952,9935,9610
5011025300,50110253,3901012,제주특별자치도 제주시 애월읍,26218,10244,13319,12899
5011025600,50110256,3901013,제주특별자치도 제주시 구좌읍,15089,6039,7555,7534
5011025900,50110259,3901014,제주특별자치도 제주시 조천읍,20680,7775,10610,10070
5011031000,50110310,3901031,제주특별자치도 제주시 한경면,8270,3544,4138,4132
5011032000,50110320,3901032,제주특별자치도 제주시 추자면,2768,1351,1502,1266
5011033000,50110330,3901033,제주특별자치도 제주시 우도면,1612,706,788,824
5011051000,50110510,3901051,제주특별자치도 제주시 일도1동,3744,1777,1886,1858
5011052000,50110520,3901052,제주특별자치도 제주시 일도2동,37962,12995,18624,19338
5011053000,50110530,3901053,제주특별자치도 제주시 이도1동,7460,3194,3681,3779
5011054000,50110540,3901054,제주특별자치도 제주시 이도2동,41418,14802,20143,21275
5011055000,50110550,3901055,제주특별자치도 제주시 삼도1동,14066,5349,6853,7213
5011056000,50110560,3901056,제주특별자치도 제주시 삼도2동,9333,4176,4665,4668
5011057000,50110570,3901057,제주특별자치도 제주시 용담1동,8737,3602,4346,4391
5011058000,50110580,3901058,제주특별자치도 제주시 용담2동,17130,6390,8642,8488
5011059000,50110590,3901059,제주특별자치도 제주시 건입동,10871,4448,5497,5374
5011060000,50110600,3901060,제주특별자치도 제주시 화북동,20035,6897,10073,9962
5011061000,50110610,3901061,제주특별자치도 제주시 삼양동,10862,3931,5495,5367
5011062000,50110620,3901062,제주특별자치도 제주시 봉개동,3087,1133,1599,1488
5011063000,50110630,3901063,제주특별자치도 제주시 아라동,13210,5179,6679,6531
5011064000,50110640,3901064,제주특별자치도 제주시 오라동,6194,2451,3207,2987
5011065000,50110650,3901065,제주특별자치도 제주시 연동,39419,16136,19285,20134
5011066000,50110660,3901066,제주특별자치도 제주시 노형동,48994,17401,24096,24898
5011067000,50110670,3901067,제주특별자치도 제주시 외도동,14197,5095,7044,7153
5011068000,50110680,3901068,제주특별자치도 제주시 이호동,4089,1525,2122,1967
5011069000,50110690,3901069,제주특별자치도 제주시 도두동,2293,883,1204,1089
5013000000,50130000,#N/A,제주특별자치도 서귀포시 ,153206,59170,77012,76194
5013025000,50130250,3902011,제주특별자치도 서귀포시 대정읍,16935,6688,8571,8364
5013025300,50130253,3902012,제주특별자치도 서귀포시 남원읍,18666,6772,9390,9276
5013025900,50130259,3902013,제주특별자치도 서귀포시 성산읍,14252,5882,7285,6967
5013031000,50130310,3902031,제주특별자치도 서귀포시 안덕면,9846,3776,4980,4866
5013032000,50130320,3902032,제주특별자치도 서귀포시 표선면,10825,4307,5447,5378
5013051000,50130510,3902051,제주특별자치도 서귀포시 송산동,5057,2036,2645,2412
5013052000,50130520,3902052,제주특별자치도 서귀포시 정방동,2806,1383,1381,1425
5013053000,50130530,3902053,제주특별자치도 서귀포시 중앙동,4507,2113,2090,2417
5013054000,50130540,3902054,제주특별자치도 서귀포시 천지동,3834,1749,1910,1924
5013055000,50130550,3902055,제주특별자치도 서귀포시 효돈동,5100,1777,2596,2504
5013056000,50130560,3902056,제주특별자치도 서귀포시 영천동,4988,1969,2506,2482
5013057000,50130570,3902057,제주특별자치도 서귀포시 동홍동,20212,7155,9916,10296
5013058000,50130580,3902058,제주특별자치도 서귀포시 서홍동,7620,2960,3865,3755
5013059000,50130590,3902059,제주특별자치도 서귀포시 대륜동,9266,3356,4679,4587
5013060000,50130600,3902060,제주특별자치도 서귀포시 대천동,7010,2508,3475,3535
5013061000,50130610,3902061,제주특별자치도 서귀포시 중문동,8751,3348,4489,4262
5013062000,50130620,3902062,제주특별자치도 서귀포시 예래동,3531,1391,1787,1744
4148038500,41480385,3120038,경기도 파주시 군내면,659,214,336,323
